[MESSAGES]
IHM_STR_ERREUR				    =	">>ERROR>> %s\n"
TCOM_MESSAGE_ERREUR_RESEAU                  =	"Time out"
PNL_INTIT_TEXT                              =	"Name Selection Panel"
PNL_INTIT_ANNULER_TEXT                      =	"__Cancel"
PNL_INTIT_VALIDER_TEXT                      =	"__Select"
PNL_INTIT_SLIDE_TEXT                        =	"DIO Board is initializing, please wait..."
PNL_INTIT_SLIDE_TEXT_PRODUCT                =	"Getting Product information (%d / %d products) ..."
PNL_INTIT_FILTRE                            =	"Filter"
PNL_MAIN_TEXT                               =	"STB Customizing"
PNL_MAIN_LIB_SLOT_TEXT                      =	"Free Slot"
PNL_MAIN_FERME_SLOT_TEXT                    =	"Close Slot"
PNL_MAIN_TEST_PRINT_SLOT_TEXT               =	"Stb Sticker"
PNL_MAIN_BT_TRACA_SLOT_TEXT                 =	"Tracking"
PNL_MAIN_BT_CONFIG_TEXT                     =	"__Config"
PNL_MAIN_TOP_PROD_TEXT                      =	"Validation"
PNL_MAIN_ACTIVE_LOG_TEXT                    =	"Activate LOG"
PNL_MAIN_TXT_INFO2_TEXT                     =	"Message..."
PNL_MAIN_TXT_RESULT_TEXT                    =	"SET TOP BOX VALID"
PNL_MAIN_SLOT_TEXT                          =	"SLOT1"
PNL_VAR_TXT_TRACA_TEXT                      =	"MANAGE VARIABLES"
PNL_VAR_STR_FILTRE_TEXT                     =	"Filter:"
PNL_VAR_CHK_FILTRE_TEXT                     =	"Configured variables"
PNL_VAR_BTN_DEFAUT_TEXT                     =	"__Default"
PNL_VAR_BTN_SAVE_TEXT                       =	"__Save"
PNL_VAR_BTN_QUIT_TEXT                       =	"__Quit"
PNL_BOUTON_TXT_INFO_ECRAN_OK_TEXT           =	"Screen OK => Press the green button"
PNL_BOUTON_TXT_INFO_ECRAN_KO_TEXT           =	"Screen OK => Press the red button"
PNL_BOUTON_TXT_INFO_TEXT                    =	"PRESS BUTTON %d"
PNL_BOUTON_TXT_INFO_TEXT_HDD                =	"Remove the HDD then press the green button"
PNL_BOUTON_TXT_INFO_TEXT_ECRAN              =	"If screen OK => press the green button"
PNL_INFO_TXT_MSG_CARD_RETIREZ               =	"\n(Time Left : %d s)"
PNL_POPUP_CB_OUI_TEXT                       =	"__YES"
PNL_POPUP_CB_NON_TEXT                       =	"__NO"
PNL_POPUP_CB_OK_TEXT                        =	"__OK"
PNL_POPUP_TEXT                              =	"Untitled Panel"
PNL_POPUP_TXT_MSG_TEXT                      =	"Text Message"
PNL_PWD_ID                                  =	"Login"
PNL_PWD_PWD                                 =	"Password"
PNL_TRACA_TEXT                              =	"Tracking parameters"
PNL_TRACA_TXT_TRACA_TEXT                    =	"TRACKING VARIABLES"
PNL_TRACA_BTN_ENRG_TEXT                     =	"__Save"
PNL_TRACA_BTN_QUIT_TEXT                     =	"__Quit"
IHM_ATTENTE_DECODEUR                        =	"WAITING SET TOP BOX"
IHM_DECODEUR_DETECTE                        =	"SET TOP BOX FOUND"
IHM_ATTENTE_DEMARRAGE_DECODEUR              =	"WAITING SET TOP BOX START"
IHM_DEPART_TEST                             =	"START TEST	"
IHM_VERIFICATION_AUTORISATION_PASSAGE       =	"VERIFYING AUTHORIZATION"
IHM_CONNEXION_NAPPE_FUSING                  =	"ARIUM FUSING CONNECTION"
IHM_LANCEMENT_SERVEUR_FTP                   =	"FTP SERVER START-UP"
IHM_LECTURE_CHIPSET_ID                      =	"READING CHIPSET ID"
IHM_GENERATION_NUMSERIE                     =	"GENERATING SERIALNUMBER"
IHM_TEST_HDD                                =	"HDD TEST"
IHM_RETRAIT_HDD                             =	"EXTRACT HDD"
IHM_TEST_PATINS_VIS                         =	"PADS AND SCREWS TEST "
IHM_TEST_COULEUR                            =	"COLOR SENSOR TEST"
IHM_TEST_BOUTONS                            =	"BUTTONS TEST"
IHM_TEST_LAME_MASSE                         =	"GROUND CHECK TEST"
IHM_TEST_INFRAROUGE                         =	"INFRARED TEST"
IHM_TEST_RF                                 =	"RF TEST"
IHM_TEST_RF4CE                              =	"RF4CE TEST"
IHM_TEST_VENTILATEUR                        =	"FAN TEST"
IHM_TEST_VENTI_TACHY                        =	"TACHYMETRIC FAN TEST"
IHM_TEST_CONSOMMATION                       =	"POWER CONSUMPTION TEST"
IHM_TEST_LED_PSOC                           =	"LEDS TEST"
IHM_TEST_SMARTCARD                          =	"SMARTCARD TEST"
IHM_TEST_USB                                =	"USB TEST"
IHM_TEST_SD_CARD                            =	"SD CARD TEST"
IHM_TEST_E_SATA                             =	"E-SATA TEST"
IHM_TEST_BR_HDMI                            =	"BLURAY - HDMI TEST"
IHM_TEST_ECRAN                              =	"SCREEN TEST"
IHM_TEST_VISION_7_SEG                       =	"7 SEGMENTS VISION TEST"
IHM_TEST_DOCSIS                             =	"DOCSIS TEST"
IHM_TEST_FLASH_NAND                         =	"NAND FLASH TEST"
IHM_TEST_FLASH_NOR                          =	"NOR FLASH TEST"
IHM_TEST_NIM                                =	"NIM TEST"
IHM_TEST_VIDEO                              =	"VIDEO TEST"
IHM_TEST_CHECK_APPLI_TT                     =	"TT & APPLICATION CHECK"
IHM_TEST_GET_STB_INFO                       =	"RETREIVING SET TOP BOX INFORMATION TEST"
IHM_TEST_CHIPSET_TEMPERATURE                =	"CHIPSET TEMPERATURE TEST"
IHM_ECRITURE_FLASH                          =	"WRITING FLASH"
IHM_SECURISATION_TRACA                      =	"SECURIZATION ET BACKGROUND DB TRACKING"
IHM_TEST_TT_CLIENT                          =	"CLIENT TT TEST"
IHM_TRACA_BDD                               =	"DB TRACKING"
IHM_IMPRESSION_ETIQUETTE                    =	"PRINTING LABEL"
IHM_PASSAGE_KO                              =	"TESTS KO"
IHM_TEST_FONCTIONNEL_TERMINE                =	"FUNCTIONNAL TEST IS OVER"
IHM_PASSAGE_OK                              =	"TESTS OK"
IHM_TEST_TERMINE                            =	"TEST IS FINISHED"
IHM_ATTENTE_RETRAIT_DECODEUR                =	"WAITING FOR SET TOP BOX REMOVAL"
IHM_DECODEUR_VALIDE                         =	"SET TOP BOX VALID"
IHM_DECODEUR_NON_VALIDE                     =	"SET TOP BOX NOT VALID"
IHM_SLOT_NUM                                =	"SLOT %d"
IHM_MODE_PROTO_SANS_DIO_WATT                =	"Proto Mode Without:\n-DIO\n-Wattmeter"
IHM_MODE_PROTO_SANS_WATT                    =	"Proto Mode Without:\n-Wattmeter"
IHM_MODE_PROTO_SANS_DIO                     =	"Proto Mode Without:\n-DIO"
IHM_MODE_PROTO                              =	"Proto Mode"
IHM_TTR_POPUP_QST_ETIQUETTE                 =	"Printing Label"
TFC_TTR_POPUP_QST_BOUTON                    =	"Buttons Test"
TFC_TTR_POPUP_QST_IR                        =	"Infrared Test"
TFC_TTR_POPUP_QST_ECRAN                     =	"Screen Test"
TFC_TTR_POPUP_QST_VIDEO                     =	"Video Test"
HDD_TTR_POPUP_QST_HDD                       =	"HDD extract Test"
FCT_TTR_POPUP_INF                           =	"INFORMATION"
FCT_TTR_POPUP_ERR                           =	"ERROR"
IHM_MSG_POPUP_QST_ETQUETTE                  =	"Print calibration label ?\n(NO -> Print product label)"
TFC_MSG_POPUP_QST_BOUTON                    =	"Do you want to continue the Buttons Test ?\n(no -> Test KO)"
TFC_MSG_POPUP_QST_IR                        =	"Do you want to try again the Infrared Test ?\n(non -> Test KO)"
TFC_MSG_POPUP_QST_ECRAN                     =	"Do you want to continue the Screen Test ?\n(no -> Test KO)"
TFC_MSG_POPUP_QST_VIDEO                     =	"Press YES if the video is visible"
HDD_MSG_POPUP_QST_HDD                       =	"Do you want to continue the HDD extract Test ?\n(no -> Test KO)"
FCT_MSG_POPUP_ERR_PROP_SFIN_NON_DEFINIE     =	">>ERROR>> the propertie linked to SFIN [%s] is not configured"
FCT_MSG_POPUP_ERR_PROP_CIE_NON_DEFINIE      =	">>ERROR>> the propertie linked to CIE [%s] is not configured"
FCT_MSG_POPUP_ERR_MES_NON_DEFINIE           =	">>ERROR>> the measure linked to CIE [%s] is not configured"
CLE_MSG_POPUP_ERR_MAC_CONSECUTIVES          =	"MAC adresses are not consecutive"
CLE_MSG_POPUP_ERR_BSK                       =	"the BSK is not between 6 and 9"
SMI_MSG_POPUP_ERR_1                         =	"Error: initializes the Cryptoki library"
SMI_MSG_POPUP_ERR_2                         =	"Error: opens a session between an application and a token"
SMI_MSG_POPUP_ERR_3                         =	"Error: initializes a message-digesting operation"
SMI_MSG_POPUP_ERR_4                         =	"Error: digests data in a single part"
SMI_MSG_POPUP_ERR_5                         =	"Error: Writing SCK2 key"
GENERIQUE_MSG_POPUP_CODE                    =	"Error code %i : %s\n\n"
GENERIQUE_MSG_POPUP_PRESSE_PAPIER           =	"%s(Message copied to clipboard)"
GENERIQUE_TTR_POPUP                         =	"Init error"
GENERIQUE_TTR_POPUP_ERR                     =	"Error"
DIO_TTR_POPUP                               =	"DIO ERROR"
DIO_MSG_POPUP_1                             =	"Cannot find lines from section \"%s\""
DIO_MSG_POPUP_2                             =	"Signal Name does not exist or is not correct"
DIO_MSG_POPUP_3                             =	"NI PCI-DIO-96 Card Peripheral number does not exist or is not correct"
DIO_MSG_POPUP_4                             =	"Port for signal \"%s\" cannot be found or is not correct"
DIO_MSG_POPUP_5                             =	"Line for signal \"%s\" cannot be found or is not correct"
DIO_MSG_POPUP_6                             =	"Active State for signal \"%s\" cannot be found or is not correct"
DIO_MSG_POPUP_7                             =	"Direction for signal \"%s\" cannot be found or is not correct"
DIO_MSG_POPUP_8                             =	"Problem while configuring a signal\n * Signal Parameters :\n  - Name : %s\n  - peripheral : %d\n  - port : %d\n  - line : %d\n  - direction : %d\n  - active state : %d\n * returned error code : %d\n * returned error message :\n=> %s"
DIO_MSG_POPUP_9                             =	"Section \"%s\" ou lines cannot be found in the init file"
ZEB_TTR_POPUP                               =	"ZEBRA ERROR"
ZEB_MSG_POPUP_5                             =	"File not found"
ZEB_MSG_POPUP_6                             =	"Cannot load file in memory"
IHM_WATT_TTR_POPUP                          =	"WATTMETER ERROR"
IHM_WATT_MSG_POPUP_1                        =	"\n***!!! Wattmeter Model cannot be found or is not correct !!!***"
IHM_WATT_MSG_POPUP_2                        =	"\n***!!! Wattmeter in mode WATT KO !!!***"
IHM_WATT_MSG_POPUP_3                        =	"\n***!!! voltage range KO !!!***"
IHM_WATT_MSG_POPUP_4                        =	"\n***!!! intensity range KO !!!***"
IHM_WATT_MSG_POPUP_5                        =	"\n***!!! Wattmetre mode : cancelling automatic mode KO !!!***"
IHM_WATT_MSG_POPUP_6                        =	"\n***!!! Cannot configure (%s) !!!***"
IHM_QUANTUM_TTR_POPUP                       =	"QUANTUM DATA ERROR"
IHM_QUANTUM_MSG_POPUP_1                     =	"\n***!!! Bad Quantum Data Configuration - Verify Database configuration values !!!***"
IHM_COM_TTR_POPUP                           =	"COM PORT ERROR"
IHM_COM_MSG_POPUP_1                         =	"%s Problem closing port COM%i\n\n"
IHM_COM_MSG_POPUP_2                         =	"%s Problem opening port COM%i\n\n"
IHM_BTN_TTR_POPUP                           =	"BUTTON PANEL ERROR"
IHM_BTN_MSG_POPUP_1                         =	"Error loading button panel"
IHM_BTN_MSG_POPUP_2                         =	"Error creating button panel"
IHM_BTN_MSG_POPUP_3                         =	"Unsupported number of buttons"
IHM_TTR_POPUP_2                             =	"Error in CIE configuration"
IHM_TTR_POPUP_3                             =	"Error in SFIN configuration"
IHM_MSG_POPUP_4                             =	"Problem while retreiving label mask \"%s\"\n\n"
IHM_MSG_POPUP_5                             =	"Problem while retreiving label logo \"%s\"\n\n"
IHM_MSG_POPUP_6                             =	"Problem while retreiving label mask error \"%s\"\n\n"
IHM_MSG_POPUP_7                             =	"Error creating IHM slot"
IHM_MSG_POPUP_8                             =	"Error starting slot's Thread"
VAR_MSG_POPUP_2                             =	"Index num %d of table tabVariables is empty, searched name %s"
VAR_MSG_POPUP_3                             =	"Problem while retreiving property %s\n\n"
VAR_MSG_POPUP_4                             =	"Error extracting variables (%s)"
TRC_MSG_POPUP_1                             =	"Unknown error while extracting product informations"
MAI_TTR_POPUP                               =	"Error in tester init"
MAI_MSG_POPUP_1                             =	"Cannot allocate system ressources"
MAI_MSG_POPUP_2                             =	"This applicaton is already opened"
MAI_MSG_POPUP_3                             =	"Error connectiong to DB: %s\n"
MAI_MSG_POPUP_4                             =	"Error retreiving station information: %s\n"
MAI_MSG_POPUP_6                             =	"%sConfig file %s not found\n\n"
MAI_MSG_POPUP_7                             =	"Server Name \"%s\" not found in section [%s] of file %s\n\n"
MAI_MSG_POPUP_8                             =	"Tag \"%s\" not found in section [%s] of file %s\n\n"
MAI_MSG_POPUP_9                             =	"%sCannot get computer name in the system\n\n"
MAI_MSG_POPUP_10                            =	"Computer name : %s not found in tag \"%s\" of section %s in the database application parameters for workstation %s\n\n"
MAI_MSG_POPUP_11                            =	"Server name \"%s\" in fichier_INI.ini unknown"
MAI_MSG_POPUP_12                            =	"Tag \"%s\" not found in section %s in the database application parameters for workstation %s\n\n"
MAI_MSG_POPUP_COPY_FONT                     =	"Error copying Sagem Font in Windows"
CAL_TTR_POPUP                               =	"Error in function %s"
FCT_TTR_POPUP_EMAIL_VAL                     =	"Error sending validation e-mail\nError: %i"
FCT_TTR_POPUP_EMAIL_ACT                     =	"Error sending e-mail activation prototype mode\nError: %i"
FCT_MSG_ERR_VERSION_BPO_TOPPROD             =	"Current Software Version :%s is not allowed. See thes list of version with a TopProd validation : "%s""
IHM_TTR_LIB_SLOT                            =	"Freeing Slot N°%d"
IHM_TTR_ESS_IMP                             =	"Printer test Slot N°%d"
IHM_MSG_LIB_SLOT                            =	"Are you sure you want to free Slot N°%d"
IHM_MSG_ESS_IMP                             =	"Are you sure you want to make a printer test on Slot N°%d"
IHM_BTN_OUI                                 =	"YES"
IHM_BTN_NON                                 =	"NO"
THR_TTR_EMAIL                               =	"Validation e-mail"
THR_MSG_EMAIL                               =	"Are you sure you want to send a validation e-mail?"
THR_LIBELLE_ERREUR_PATINS_VIS               =	"Pads or Screws Error"
THR_LIBELLE_ERREUR_COULEUR                  =	"Color Sensor Error"
THR_LIBELLE_ERREUR_LAME_MASSE               =	"Ground Check Erreur"
THR_LIBELLE_ERREUR_DEMARRAGE                =	"Set Top Box Boot KO\n"
THR_LIBELLE_ERREUR_AUTORISATION             =	"Authorization KO\n"
THR_LIBELLE_ERREUR_LECTURE_NUID             =	"Problem reading UniqueId"
THR_LIBELLE_ERREUR_PRISE_SN_CLIENT          =	"Error with client SN"
THR_LIBELLE_ERREUR_ECRITURE_FLASH           =	"Error writing in flash"
THR_LIBELLE_ERREUR_TT_CLIENT                =	"Error in client TT"
THR_LIBELLE_ERREUR_TRACA_PARA               =	"Error in background tracking"
THR_LIBELLE_ERREUR_TRACA                    =	"Error in tracking"
THR_LIBELLE_ERREUR_IMPRESSION               =	"Error printing"
THR_LIBELLE_ERREUR_LOGO                     =	"Error loading logo"
THR_LIBELLE_ERREUR_LIBERATION_SLOT          =	"Slot freeing forced"
THR_LIBELLE_ERREUR_FERMETURE_APPLI          =	"Application Closed"
THR_LIBELLE_ERREUR_LED                      =	"Error LED test"
THR_LIBELLE_ERREUR_SMC_PRESENCE             =	"Error SMC presence"
THR_LIBELLE_ERREUR_USB                      =	"Error USB"
THR_LIBELLE_ERREUR_ESATA                    =	"Error eSata"
THR_LIBELLE_ERREUR_SD_CARD                  =	"Error SD Card"
THR_LIBELLE_ERREUR_IR                       =	"Error Infrared"
THR_LIBELLE_ERREUR_RF                       =	"Error RF"
THR_LIBELLE_ERREUR_RF4CE                    =	"Error RF4CE"
THR_LIBELLE_ERREUR_FLASH_NOR                =	"Error NOR Flash test"
THR_LIBELLE_ERREUR_FLASH_NAND               =	"Error NAND Flash test"
THR_LIBELLE_ERREUR_ECRAN                    =	"Error screen test"
THR_LIBELLE_ERREUR_VISION_7_SEG             =	"Error 7 Segments Vision Test"
THR_LIBELLE_ERREUR_HDD                      =	"Error HDD"
THR_LIBELLE_ERREUR_BOUTON                   =	"Error buttons Test"
THR_LIBELLE_ERREUR_SMC_ABSENCE              =	"Error SMC absent"
THR_LIBELLE_ERREUR_EXTRACTION_HDD           =	"Error extract HDD test"
THR_LIBELLE_ERREUR_CONSO_VENTILO            =	"Error Power consumption/Fan"
THR_LIBELLE_ERREUR_VENTI_TACHY              =	"Error tachymetric Fan"
THR_LIBELLE_ERREUR_VENTILO                  =	"Error Fan"
THR_LIBELLE_ERREUR_DOCSIS                   =	"Error reading Mac docsis address"
THR_LIBELLE_ERREUR_NIM                      =	"Error NIM"
THR_LIBELLE_ERREUR_VIDEO                    =	"Error video"
THR_LIBELLE_ERREUR_HDMI                     =	"Error Bluray Hdmi"
THR_LIBELLE_ERREUR_CHECK_APLLI_TT           =	"Error TT and aplication check"
THR_LIBELLE_ERREUR_TEST_GET_STB_INFO        =	"Error retreiving set top box information"
THR_LIBELLE_ERREUR_TEST_CHIPSET_TEMPERATURE =	"Error Chipset Temperature"
THR_LIBELLE_ERREUR_LECTURE_CLE              =	"Error reading key"
FCT_LIBELLE_ERREUR_SN                       =	"Error generating SN"
FCT_LIBELLE_ERREUR_SN_NC                    =	"Error generating SN Numericable"
FCT_LIBELLE_ERREUR_SN_BYT                   =	"Error generating SN Bouygues"
FCT_LIBELLE_ERREUR_SN_CHIL                  =	"Error generating SN Chili"
FCT_LIBELLE_ERREUR_CODE_MATERIEL            =	"Error generating Hardware code"
FCT_LIBELLE_ERREUR_SN_VODA                  =	"Error generating SN Vodaphone"
FCT_LIBELLE_ERREUR_SN_CYFRA                 =	"Error generating SN Cyfra+"
FCT_LIBELLE_ERREUR_SN_DSI87SFR              =	"Error generating SN DSI87 SFR"
FCT_LIBELLE_ERREUR_SN_M45                   =	"Error generating SN M45"
FCT_LIBELLE_ERREUR_SN_IAD84HA               =	"Error generating SN IAD84 Hansenet"
FCT_LIBELLE_ERREUR_SN_DIGITURK              =	"Error generating SN Digiturk"
FCT_LIBELLE_ERREUR_SN_DCI85KDG              =	"Error generating SN DCI85KDG"
FCT_LIBELLE_ERREUR_SN_CLIENT                =	"Error generating customer serial number \'%s\'"
FCT_LIBELLE_ERREUR_VERIF_LOCK_FLASH         =	"Error verifying if flash locked"
FCT_LIBELLE_ERREUR_CRYPT_HDD                =	"Error encrypting HDD data"
FCT_LIBELLE_ERREUR_WRT_SN                   =	"Error writing SN Sagem"
FCT_LIBELLE_ERREUR_WRT_CERTIFICAT_SSL       =	"Error writing SN for SSL certificate"
FCT_LIBELLE_ERREUR_WRT_SN_NC                =	"Error writing SN Numericable"
FCT_LIBELLE_ERREUR_WRT_SN_BYT               =	"Error writing SN Bouygues"
FCT_LIBELLE_ERREUR_WRT_SN_VODA              =	"Error writing SN Vodaphone"
FCT_LIBELLE_ERREUR_WRT_SN_DSI87_SFR         =	"Error writing SN DSI87 SFR"
FCT_LIBELLE_ERREUR_WRT_SN_DIGITURK          =	"Error writing SN Digiturk"
FCT_LIBELLE_ERREUR_WRT_SN_CLIENT            =	"Error writing SN %s"
FCT_LIBELLE_ERREUR_ECRITURE_BADBLOCKS       =	"Error writing Bad Blocks number"
FCT_LIBELLE_ERREUR_DESACTIV_ETHERNET        =	"Error desactivating Ethernet"
FCT_LIBELLE_ERREUR_WRT_CLES                 =	"Error writing keys"
FCT_LIBELLE_ERREUR_WRT_RECUP_NAGRA          =	"Error retreiving Nagra infos"
FCT_LIBELLE_ERREUR_WRT_DOCSIS               =	"Error writing SetMac Docsis"
FCT_LIBELLE_ERREUR_WOL                      =	"Error Wake on Lan test"
FCT_LIBELLE_ERREUR_UNICITE                  =	"Error in uniqueness violation filters"
FCT_LIBELLE_ERREUR_WRTTRACKING              =	"Error writing writetracking"
FCT_LIBELLE_ERREUR_WRT_FLASH                =	"Error writing in flash"
FCT_LIBELLE_ERREUR_CONFIGURATION            =	"Database configuration Error"
FCT_LIBELLE_ERREUR_PARAMETRAGE              =	"Configuration Error in the database application parameters"
FCT_LIBELLE_ERREUR_CNX_TELNET_SWITCH        =   "Connection Telnet Switch SP8T KO %s !!!"            
FCT_LIBELLE_ERREUR_PASSWORD_SWITCH          =   "Error Password Switch SP8T !!!"
FCT_LIBELLE_ERREUR_VERSION_TT               =   "Error Version TT"
FCT_LIBELLE_ERREUR_LECTURE_SN               =   "ERROR SN"
FCT_LIBELLE_ERREUR_SFC_PARENT               =   "No SFC Parent found for this SnCIE:  %s"
FCT_LIBELLE_ERREUR_SFC_TROUVE               =   "SFC Found for this SnCIE: %s"
FCT_LIBELLE_ERREUR_RECUPERATION_SFC_PARENT  =   "Error in the recovery of the parent SFC for SFC/Component: %s."


WRT_LIBELLE_ERREUR_WRT_HARDWARE_ID          =	"Error writing Hardware Id"
WRT_LIBELLE_ERREUR_WRT_MANU_ID              =	"Error writing Manufacturer Id"
WRT_LIBELLE_ERREUR_WRT_HARD_VERSION         =	"Error writing Hardware Version"
WRT_LIBELLE_ERREUR_WRT_DWL_ID               =	"Error writing Download Id"
WRT_LIBELLE_ERREUR_WRT_IP                   =	"Error writing download server IP"
WRT_LIBELLE_ERREUR_WRT_PATH                 =	"Error writing download path"
WRT_LIBELLE_ERREUR_WRT_CRYPT_FLUX           =	"Error encrypting flow"
WRT_LIBELLE_ERREUR_WRT_CMD_FIN              =	"Error in set top box finalization command"
WRT_LIBELLE_ERREUR_WRT_PRERECETTE           =	"Error activating custom boot in pre-checkout"
WRT_LIBELLE_ERREUR_WRT_SWITCH_TT_PANA       =	"Error switch to Panasonic TT"
WRT_LIBELLE_ERREUR_WRT_CHECK_APPLI_PANA     =	"Error check to Panasonic Appli"
WRT_LIBELLE_ERREUR_WRT_SWITCH_TO            =	"Error forcing switch TT to application"
WRT_LIBELLE_ERREUR_WRT_FORC_TEL             =	"Error forcing download"
WRT_LIBELLE_ERREUR_WRT_EFFACEMENT_TT        =	"Error deleting TT zone"
WRT_LIBELLE_ERREUR_WRT_LOCK_FLASH           =	"Error locking flash"
WRT_LIBELLE_ERREUR_WRT_REVERIF_LOCK_FLASH   =	"Error verifying flah locking"
WRT_LIBELLE_ERREUR_WRT_RECUP_PWD_JTAG       =	"Error retreiving jtag locking password"
WRT_LIBELLE_ERREUR_WRT_LOCK_JTAG            =	"Error locking jtag"
WRT_LIBELLE_ERREUR_WRT_CHIP_PAIRING         =	"Error pairing chipset"
WRT_LIBELLE_ERREUR_WRT_CRYPTOCORE           =	"Error activating cryptocore"
WRT_LIBELLE_ERREUR_WRT_FUSE_STATUS          =	"Error Get Fuse Status"
WRT_LIBELLE_ERREUR_WRT_DRM_FUSE             =	"Error DRM fuse"
WRT_LIBELLE_ERREUR_WRT_MES_FUSE             =	"Error activating MES"
HDD_LIBELLE_ERREUR                          =	"Error in HDD test"
HDD_LIBELLE_ERREUR_SN_HDD                   =	"HDD serial number could not be read"
HDD_LIBELLE_ERREUR_LEC_MODEL_HDD            =	"HDD model could not be read"
HDD_LIBELLE_ERREUR_MODEL_HDD                =	"HDD model in database is different from the current HDD"
HDD_LIBELLE_ERREUR_SIZE_HDD                 =	"HDD size in database is different from the current HDD"
HDD_LIBELLE_ERREUR_FIRMWARE_HDD             =	"HDD firmware in database is different from the current HDD"
HDD_LIBELLE_ERREUR_RETRAIT1_HDD             =	"Error during 1st HDD extract test"
HDD_LIBELLE_ERREUR_RETRAIT2_HDD             =	"Error during 2nd HDD extract test"
HDD_LIBELLE_ERREUR_SUP_DOUBLON              =	"Deleting HddPwd duplicates KO"
HDD_LIBELLE_ERREUR_HDD_EMBALLE              =	"HDD is already packed"
HDD_LIBELLE_ERREUR_VERIF_HDD_EMBALLE        =	"Error verifying if HDD not packed"
HDD_LIBELLE_ERREUR_HDD_LOCK                 =	"This HDD is locked!"
HDD_LIBELLE_ERREUR_HDD_NON_LOCK             =	"This HDD is not locked!"
HDD_LIBELLE_ERREUR_PASSAGE_BHD              =	"This HDD has not gone through the HDD testbed"
HDD_LIBELLE_ERREUR_PASSAGE_KO_BHD           =	"This HDD was tested KO on the HDD testbed"
HDD_LIBELLE_ERREUR_PARENTS_HDD              =	"This HDD has several SNSFIN parents"
HDD_LIBELLE_ERREUR_VERIF_PASSAGE_BHD        =	"Error verifying HDD testbed authorization"
HDD_LIBELLE_ERREUR_NOMENCLATURE_HDD         =	"There is no HDD in the nomenclature"
HDD_LIBELLE_ERREUR_CREATION_CIE_HDD         =	"Error creating HDD CIE"
HDD_LIBELLE_ERREUR_FORMATAGE_SSD            =	"Error verifying SSD card formating"
HDD_LIBELLE_ERREUR_NON_LIEN_HDD             =	"Error verifying HDD not linked"
HDD_LIBELLE_ERREUR_PWD_UNIQUE               =	"A UNIQUE password allready belong to this Hdd Serial Number"
HDD_LIBELLE_ERREUR_TEST_PARTITIONS          =	"Error checking partitions"
HDD_LIBELLE_ERREUR_RECUP_PARTITIONS         =	"Error while getting informations from partition : %s"
CLE_LIBELLE_ERREUR_LECTURE                  =	"Could not read %s key"
CLE_LIBELLE_ERREUR_ECRITURE                 =	"Error writing %s key"
LIE_LIBELLE_ERREUR_LIEN                     =	"%s is already linked"
CLE_MSG_FIL2LO                              =	"Could not verify video with this test vector"
FCT_MSG_FIL2LO                              =	"!! REFERENCE CARD !!"
THR_MSG_FIL2LO                              =	"!! PROTO MODE => DEACTIVATE AUTHORIZATION VERIFICATION !!"
FIL2LO_STR_WARNING_LOCK_NDS                 =	"!! WARNING => NDS LOCK FLASH DESACTIVATES FLA_LOCK 0 COMMAND !!"
FIL2LO_STR_CONF_STB                         =	"######## STB CONFIGURATION #######################"
FIL2LO_STR_TRACE_STB                        =	"######## STB STACK ###############################"
FIL2LO_STR_RES_OK                           =	"############ TESTS OK ############\n"
FIL2LO_STR_RES_KO                           =	"############ TESTS KO ############"
FIL2LO_STR_DEBUT_TEST                       =	"START OF TEST"
FIL2LO_STR_FIN_TEST                         =	"END OF TEST"
FIL2LO_STR_ERREUR                           =	"ERROR : %s\n"
FIL2LO_STR_DUREE_TEST                       =	"TEST LENGTH : %d ms\n"
FIL2LO_STR_SOFT_VERSION                     =	"SOFT VERSION : %s\n"
FIL2LO_STR_SN_CIE                           =	"SN of CIE         : %s\n"
FIL2LO_STR_CODE_PRODUIT                     =	"               Product code      : %s\n"
FIL2LO_STR_INDICE                           =	"               Index             : %s\n"
FIL2LO_STR_SFIN_INDICE                      =	"               SFIN index        : %s\n"
FIL2LO_STR_LOADER                           =	"               Loader            : %s\n"
FIL2LO_STR_APPLISOFT                        =	"               AppliSoft         : %s\n"
FIL2LO_STR_TT                               =	"               TT                : %s\n"
FIL2LO_STR_NOMENCLATURE_HW                  =	"               Nomenclature Hw   : %s\n"
FIL2LO_STR_NOMENCLATURE_BOOT                =	"               Nomenclature Boot : %s\n"
DIO_MSG_FIL2LO                              =	"Error LedsOff\n"
THR_MSG_CONTEXT_LED_PSOC                    =	"Executing Test LED"
THR_MSG_CONTEXT_SMARTCARD                   =	"Executing Test smartcard"
THR_MSG_CONTEXT_USB                         =	"Executing Test USB"
THR_MSG_CONTEXT_ESATA                       =	"Executing Test eSATA"
THR_MSG_CONTEXT_SDCARD                      =	"Executing Test SD card"
THR_MSG_CONTEXT_IR                          =	"Executing Test Infrared"
THR_MSG_CONTEXT_RF                          =	"Executing Test RF"
THR_MSG_CONTEXT_FLASHNOR                    =	"Executing Test FLASH NOR"
THR_MSG_CONTEXT_FLASHNAND                   =	"Executing Test FLASH NAND"
THR_MSG_CONTEXT_ECRAN                       =	"Executing Test screen"
THR_MSG_CONTEXT_HDD                         =	"Executing Test HDD"
THR_MSG_CONTEXT_BOUTONS                     =	"Executing Test buttons"
THR_MSG_CONTEXT_CONSO                       =	"Executing Test Power consumption"
THR_MSG_CONTEXT_VENTI_TACHY                 =	"Executing Test Tachymetric Fan"
THR_MSG_CONTEXT_VENTILO                     =	"Executing Test Fan"
THR_MSG_CONTEXT_DOCSIS                      =	"Executing Test MAC Docsis"
THR_MSG_CONTEXT_NIM                         =	"Executing Test NIM"
THR_MSG_CONTEXT_VIDEO                       =	"Executing Test video"
THR_MSG_CONTEXT_HDMI                        =	"Executing Test Hdmi"
THR_MSG_CONTEXT_CHECK_APPLI_TT              =	"Executing Test TT and application check"
THR_MSG_CONTEXT_TEST_GET_STB_INFO           =	"Executing Test set top box information retreival"
THR_MSG_CONTEXT_TEST_CHIPSET_TEMPERATURE    =	"Executing Test Chipset Temperature"
CLE_MSG_CONTEXT_LECTURE_CLE                 =	"Reading key %s"
MAI_TTR_EMAIL_FERMETURE1                    =	"Closing %s %s"
MAI_TTR_EMAIL_FERMETURE2                    =	"Closing %s %s %s-%s %s - %s(CIE)"
CLE_TTR_EMAIL_CHECK_NUMBER                  =	"Nagra Check Number"
CLE_MSG_EMAIL_CHECK_NUMBER                  =	"Check Number before writing PK: %s is different from Check Number after writing PK: %s"
CLE_TXT_DATE                                =	"Date: "
CLE_TXT_HEURE                               =	"Hour: "
CLE_TXT_CODE_PRODUIT                        =	"Product Code: "
CLE_TXT_INDICE                              =	"Index: "
CLE_TXT_SN                                  =	"Serial Number: "
ZEB_MSG_LOG_CAS_ID                          =	"Formatted Cas ID : %s"
ZEB_MSG_LOG_DATE                            =	"Date : %s"
LIE_MSG_ACC_DEJA_LIE_AUTRE_DEC              =	"Accessory already linked to this set top box : %s"
LIE_MSG_ACC_DEJA_LIE                        =	"Accessory already linked to current set top box : %s"
LIE_MSG_SUP_LIEN                            =	"Deleting link between SN CIE Accessory: %s and SN SFIN Stb"
LIE_MSG_DEC_DEJA_LIE                        =	"Set Top Box already linked to current accessory: %s"
MES_MSG_MES_NON_RECONNU                     =	"Measure \"%s\" : Information with unknown measure (%s)"
MES_MSG_MES_ENREGISTREMENT                  =	"[Saving measure %s] %s"
THR_MSG_ERR_DETECTION_VIS                   =	"Error detecting screw : screw n°%d is not present"
THR_MSG_ERR_DETECTION_PATINS                =	"Error detecting pad : pad n°%d is not present"
THR_MSG_ERR_DETECTION_COULEUR               =	"Error detecting color sensor : sensor n°%d is not present"
THR_MSG_DEMMARAGE                           =	"Set Top Box boot OK\n"
THR_MSG_AUTORISATION_PASSAGE                =	"Authorization OK\n"
THR_MSG_ERR_THREAD_LOGO                     =	"Error starting ChargerLogoZebra Thread"
THR_MSG_ERR_THREAD_TESTFONC                 =	"Error starting TestFonc Thread"
THR_MSG_ERR_THREAD_LECTUREBDD               =	"Error starting LectureBdd Thread"
THR_MSG_ERR_THREAD_SECURE                   =	"Error starting Sécurisation Thread"
THR_MSG_ERR_THREAD_TRACA_PARA               =	"Error starting Traçabilité Parallèle Thread"
THR_MSG_ECRITURE_FLASH                      =	"Writing informations in flash OK\n"
THR_MSG_SECURISATION_TRACA                  =	"Securization and backgournd DB Tracking OK\n"
THR_MSG_TEST_TT_CLIENT                      =	"Client TT OK\n"
THR_MSG_TRACA                               =	"Tracking OK\n"
THR_MSG_LIBERATION_SLOT                     =	"Freeing slot"
THR_MSG_ERR                                 =	"ERROR: %s"
THR_MSG_RETRAIT_STB                         =	"SET TOP BOX REMOVED FROM SLOT (TIME = %d)\n"
THR_MSG_ERR_DEVEROUILLAGE                   =	"Problem while unlocking headband"
THR_MSG_TESTFONC_SKIPPE                     =	"Functionnal test skipped according to compilation option"
THR_MSG_FIN_THREAD_LOGO                     =	"End of logo thread"
THR_MSG_FIN_THREAD_TESTFONC                 =	"End of functionnal thread"
THR_MSG_FIN_THREAD_LECTUREBDD               =	"End of keys reading thread"
THR_MSG_FIN_THREAD_SECURISATION             =	"End of Sécurisation thread"
THR_MSG_FIN_THREAD_TRACA_PARA               =	"End of Traçabilité Parallèle thread"
THR_MSG_ERR_NVM                             =	"Error NVM : Key header is not conform\n NvmHeader = [0x%02x,0x%02x,0x%02x,0x%02x]"
THR_MSGL_DUREE_LOGO                         =	"Logo loading time: %dms\n"
WOL_MSG_SLEEP                               =	"Sleep %i ms"
WOL_MSG_ERR_ENVOIE                          =	"Error sending WOL frame"
WOL_MSG_TIMEOUT                             =	"TimeOut %i s"
WOL_MSG_ERR_WOL1                            =	"Error Wake On Lan: %s"
WOL_MSG_ERR_WOL2                            =	"Error Wake On Lan"
WOL_MSG_WOL_OK                              =	"Wake On Lan: OK"
VAR_MSG_ERR_VAR_INCONNU                     =	"Unknown variable type (%d)"
VAR_MSG_ERR_VAR_ENREGISTREMENT1             =	"Saving variables state [%s] : %s"
VAR_MSG_ERR_VAR_ENREGISTREMENT2             =	"Saving variables state [%s]"
VAR_MSG_ERR_PROP_SUP                        =	"Deleting property: %s"
VAR_MSG_ERR_VAR_UNIQUE_SUP1                 =	"Deleting unique state variables[%s] : %s"
VAR_MSG_ERR_VAR_UNIQUE_SUP2                 =	"Deleting unique state variables [%s]"
IHM_MSG_APPUYER_BTN                         =	"Press all buttons on the front panel ..."
TRC_MSG_ERR_INCONNU                         =	"Unknown error while retreiving station informations"
TRC_MSG_ERR_SN_NON_GENERE                   =	"SN not generated"
TRC_MSG_ERR_CODE_PASSAGE                    =	"Test Code = %d \"%s\""
TRC_MSG_CODE_PASSAGE                        =	"Test Code = %d"
TRC_MSG_ERR_CODE_DOUBLON                    =	"Duplicate Code = %d \"%s\""
TRC_MSG_CODE_DOUBLON                        =	"Duplicate Code = %d"
TRC_MSG_SUP_DOUBLON                         =	"Deleting duplicates %s: %s on CIE: %s"
TRC_MSG_ERR_ALLOCATION_MEMOIRE              =	"Problem allocating memory"
TRC_MSG_ERR_ECRITURE_CLE                    =	"Error writing key to database"
CLE_MSG_VALEUR1                             =	"Extracting key value <%s> : key does not exist"
CLE_MSG_VALEUR2                             =	"Extracting key value <%s> : impossible"
CLE_MSG_NETTOYAGE1                          =	"Cleaning key %s [Table:%s] [ID:%d]"
CLE_MSG_NETTOYAGE2                          =	"Cleaning key <%s> : key does not exist"
CLE_MSG_NETTOYAGE3                          =	"Cleaning key <%s> KO : %s"
CLE_MSG_NETTOYAGE4                          =	"Cleaning key <%s> KO"
CLE_MSG_LECTURE1                            =	"End reading key %s : OK (ID = %d)"
CLE_MSG_LECTURE2                            =	"End reading key %s : KO \"%s\""
CLE_MSG_LECTURE3                            =	"No more available keys"
CLE_MSG_ECRITURE1                           =	"Writing key %s"
CLE_MSG_ECRITURE2                           =	"End writing %s : OK"
CLE_MSG_ECRITURE3                           =	"End writing %s : KO: %s"
CLE_MSG_LIBERATION1                         =	"Freeing key %s [Table:%s - ID:%d]"
CLE_MSG_LIBERATION2                         =	"Freeing key %s impossible \"%s\""
CLE_MSG_LIBERATION3                         =	"Freeing key %s impossible"
CLE_MSG_INFO_NAGRA1                         =	"Start: retreiving NAGRALOG informations"
CLE_MSG_INFO_NAGRA2                         =	"End: retreiving NAGRALOG informations"
CLE_MSG_INFO_NAGRA3                         =	"Error sending e-mail"
CLE_MSG_INFO_NAGRA4                         =	"Retreiving NAGRALOG informations"
CLE_MSG_INDICE_CLES1                        =	"There is no configured keys matching this table name"
CLE_MSG_INDICE_CLES2                        =	"Looking for a key index : KO %s"
CLE_MSG_LECTURE_STBPWD                      =	"Key \"stbpasswords\" generated by the TT"
CLE_MSG_MISE_EN_FORME_HDCP                  =	"Error verifying CRC (SHA Calculation)"
CLE_MSG_ECRITURE_NDS_DCI85KDG               =	"Saving SN client DCI 85 KDG"
CLE_MSG_ERREUR_VERIF_SMI1                   =	"STB Chipset ID (=%s) is different of DataBase Chipset PID (=%s)"
CLE_MSG_ERREUR_VERIF_SMI2                   =	"STB Chipset ID (=%s) is different is different STB Chipset ID recorded from BAV (=%s)"
CLE_MSG_ERREUR_NUM_CENTRE                   =	"This Factory Number is not supported"
HDD_MSG_MODELE                              =	"HDD model : %s"
HDD_MSG_SN                                  =	"HDD serial number : %s"
HDD_MSG_RESA_CLE_SN                         =	"Reservation or password retrieved on this HDD SN: %s"
HDD_MSG_LOCKAGE                             =	"HDD lockstate : %s"
HDD_MSG_TAILLE                              =	"HDD size : %d Go"
HDD_MSG_FIRMWARE                            =	"HDD firmware : %s"
HDD_MSG_PAIRING_OK                          =	"HDD pairing OK"
HDD_MSG_ERR_PAIRING_KO                      =	"HDD pairing KO"
HDD_MSG_PAIRING_SANS_LOCK_OK                =	"HDD pairing without lock OK"
HDD_MSG_ERR_PAIRING_SANS_LOCK_KO            =	"HDD pairing without lock KO"
HDD_MSG_PAIRING_PLUS_LOCK_OK                =	"HDD pairing with lock OK"
HDD_MSG_ERR_PAIRING_PLUS_LOCK_KO            =	"HDD pairing with lock KO"
HDD_MSG_DEJA_LOCKE                          =	"HDD is already locked\n"
HDD_MSG_DELOCKAGE_KO                        =	"Unlocking KO\n"
HDD_MSG_RELOCKAGE_KO                        =	"Relocking KO\n"
HDD_MSG_GENERATION_PWD_LOCK                 =	"Generating locking password\n"
HDD_MSG_PWD_DEJA_PRESENT                    =	"Locking password already exist on this CIE\n"
HDD_MSG_ERR_GENERATION_CLES_PAIRING         =	"Error generating pairing keys"
HDD_MSG_DEJA_EMBALLE                        =	"This HDD is already packed with set top box : %s"
HDD_MSG_LOCKE_OK                            =	"HDD locked"
HDD_MSG_NBR_SFIN_HDD                        =	"This HDD has %d SN SFIN"
HDD_MSG_SN_SFIN_HDD                         =	"Sn Sfin: %s"
HDD_MSG_PASSAGE_KO_BHD                      =	"This HDD %s was tested KO on BHD testbed on the %s"
HDD_MSG_PASSAGE_OK_BHD                      =	"This HDD %s was tested OK on BHD testbed on the %s"
HDD_MSG_CREATION_SN_CIE_HDD                 =	"Creating HDD SN CIE : %s"
HDD_MSG_HDD_ABSENT_NOMENCLATURE             =	"There is no HDD in the nomenclature"
HDD_MSG_SN_CIE_HDD_DEJA_PRESENT             =	"This HDD SN CIE: %s already exists"
HDD_MSG_CODE_PRODUIT_CIE_HDD                =	"Product code CIE HDD %s"
HDD_MSG_ERR_CODE_PRODUIT_HDD                =	"Product code CIE HDD read: %s is different from the expected product code: %s"
HDD_MSG_TEST_PARTITIONS                     =	"Checking Partitions :"
HDD_MSG_TEST_PARTITIONS_OK                  =	"Checking Partitions OK"
HDD_MSG_PRES_PARTITION                      =	"Partition : %s found"
HDD_MSG_ABS_PARTITION                       =	"Partition : %s not found"
HDD_MSG_BLOCS_PARTITION_OK                  =	"Number of blocks found: %d greater or equal to the number of blocks defined in database : %d"
HDD_MSG_BLOCS_PARTITION_NOK                 =	"Error : Number of blocks found: %d less than the number of blocks defined in database : %d"
HDD_MSG_TYPE_PARTITION_OK                   =	"Partition type found: %s compliant with type defined in database: %s"
HDD_MSG_TYPE_PARTITION_NOK                  =	"Error : Partition type found: %s différent from type defind in database : %s"
TFC_MSG_PAT1_DETECTE                        =	"Pad 1 detected"
TFC_MSG_PAT2_DETECTE                        =	"Pad 2 detected"
TFC_MSG_PAT3_DETECTE                        =	"Pad 3 detected"
TFC_MSG_PAT4_DETECTE                        =	"Pad 4 detected"
TFC_MSG_PAT5_DETECTE                        =	"Pad 5 detected"
TFC_MSG_VIS1_DETECTEE                       =	"Screw 1 detected"
TFC_MSG_VIS2_DETECTEE                       =	"Screw 2 detected"
TFC_MSG_VIS3_DETECTEE                       =	"Screw 3 detected"
TFC_MSG_VIS4_DETECTEE                       =	"Screw 4 detected"
TFC_MSG_COUL1_DETECTE                       =	"Color Sensor 1 detected"
TFC_MSG_DEMSTB_ERR_COM                      =	"Error COM [%d]: %s\n"
TFC_MSG_DEMSTB_DEM_CHRONO                   =	"BOOTING SET TOP BOX (TIME = %d)\n"
TFC_MSG_DEMSTB_ERR_PREALIMENTATION          =	"PREALIMENTATION IS NOT POSSIBLE WITH THIS TT"
TFC_MSG_DEMSTB_ERR_CMD_TT_INIT              =	"Error in set top box init command"
TFC_MSG_VTL_OFF                             =	"Fan OFF ( 0%) KO"
TFC_MSG_CONSO_PW                            =	"Power consumption : %f\n"
TFC_MSG_VTL_ON                              =	"Fan ON (100%) KO"
TFC_MSG_VTL_OK                              =	"Fan presence OK"
TFC_MSG_VTL_ERR_KO                          =	"Fan presence KO"
TFC_MSG_CONSO_VTL                           =	"Fan power consumption : %f\n\n OK"
TFC_MSG_VTL_ERR_CONSO                       =	"Fan power consumption : %f\n\n KO"
TFC_MSG_CONSO_ERR_LECTURE                   =	"Cannot read power consumption"
TFC_MSG_BTN_ERR_ACTIVATION                  =	"Error activating buttons"
TFC_MSG_BTN_ERR_DESACTIVATION               =	"Error deactivating buttons"
TFC_MSG_BTN_CONF_NB_APPUIS                  =	"Number of pulses expected  : "
TFC_MSG_BTN_CONF_ORDRE                      =	"Press in predefined ordre"
TFC_MSG_BTN_CONF_SIMULTANE                  =	"Simultaneous press detection activated"
TFC_MSG_BTN_OK                              =	"Button %d OK"
TFC_MSG_BTN_OUVERTURE_POP_UP                =	"Opening button popup"
TFC_MSG_BTN_FERMETURE_POP_UP                =	"Closing popup button"
TFC_MSG_BTN_ERR_KO                          =	"Buttons operation KO"
TFC_MSG_BTN_ERR_DATE                        =	"Error while getting date format"
TFC_MSG_BTN_ERR_TIMEOUT                     =	"Time Out detected.\n"
TFC_MSG_BTN_ERR_SIMULTANE                   =	"Simultaneous press detected.\n"
TFC_MSG_BTN_ERR_DESORDRE                    =	"Press in disorder detected.\n"
TFC_MSG_IR_RUWIDO                           =	"Switching to RUWIDO protocol KO"
TFC_MSG_IR_ERR_NEC                          =	"Set Top Box is not switching to NEC mode"
TFC_MSG_IR_ERR_IR                           =	"Set Top Box is not switching to Infrared mode"
TFC_MSG_IR_TOUCHE_OK                        =	"Waiting for OK button to be pressed ..."
TFC_MSG_IR_RF_TOUCHE_ROUGE                  =	"Waiting for RED button to be pressed ..."
TFC_MSG_IR_RF_TOUCHE_0                      =	"Waiting for 0 button to be pressed ..."
TFC_MSG_IR_CODE_RECU                        =	"Remote Control code received : %03d"
TFC_MSG_IR_RF_CODE_RECU_SFR                 =	"Remote Control code received : 0x%x"
TFC_MSG_IR_ERR                              =	"Error IR : %s"
TFC_MSG_IR_OUVERTURE_POP_UP                 =	"Opening Infrared popup"
TFC_MSG_IR_FERMETURE_POP_UP                 =	"Closing Infrared popup"
TFC_MSG_RF_ERR_PW                           =	"RF emmiter power must be between -18dBm to 10dBm"
TFC_MSG_RF_ERR_PASSAGE_PROTOCOLE_RF         =	"Switching to RF protocol KO"
TFC_MSG_RF_ERR_PASSAGE_RF                   =	"Set Top Box is not switching to RF mode"
TFC_MSG_RF_ERR_SYNCWORD                     =	"Set Top Box is not modifying its SyncWord value"
TFC_MSG_RF_ERR_MODULE                       =	"RF module is not responding"
TFC_MSG_RF_ERR                              =	"Error RF : %s"
TFC_MSG_USB_INSERTION                       =	"Insert USB key"
TFC_MSG_USB_DETECTION                       =	"USB detected"
TFC_MSG_USB_ERR                             =	"USB not detected"
TFC_MSG_SD_INSERTION                        =	"Insert SD card"
TFC_MSG_SD_DETECTION                        =	"SD card detected"
TFC_MSG_SD_ERR_CMDTT                        =	"CmdTT is not defined for SD card test"
TFC_MSG_SD_ERR                              =	"SD card not detected"
TFC_MSG_NAND_ID                             =	"Flash Nand ID : %s\n"
TFC_MSG_NAND_ERR_ID_NONCONFORME             =	"FLASH ID not conform [%s] !"
TFC_MSG_NAND_ERR_ID                         =	"Flash Nand identifier not found in TT answer !"
TFC_MSG_NAND_TAILLE                         =	"Flash Nand Size : %s\n"
TFC_MSG_NAND_ERR_TAILLE_NONCONFORME         =	"FLASH size not conform [%s] !"
TFC_MSG_NAND_ERR_TAILLE                     =	"Flash Nand size not found in TT answer !"
TFC_MSG_NAND_ERR                            =	"FLASH NAND Test KO"
TFC_MSG_CARD_INSERTION                      =	"Insert Smartcard"
TFC_MSG_CARD_ERR_DETECTION                  =	"Smartcard not detected"
TFC_MSG_CARD_DETECTION                      =	"Smartcard detected"
TFC_MSG_CARD_RETIREZ                        =	"Remove the smartcard"
TFC_MSG_CARD_ERR_RETRAIT                    =	"Removal of smartcard not detected"
TFC_MSG_CARD_RETRAIT                        =	"Removal of smartcard detected"
TFC_MSG_DOCSIS_ERR_VERSION_NONLUE           =	"Docsis version could not be read"
TFC_MSG_DOCSIS_ERR_VERSION_DIFF             =	"Docsis vendor version (%s) is different for set top box version (%s)"
TFC_MSG_DOCSIS_ERR_VERSION_SOFT             =	"Docsis soft version (%s) is different for set top box version (%s)"
TFC_MSG_DOCSIS_ERR_ADRESSE_NONLUE           =	"Docsis modem address could not be read"
TFC_MSG_DOCSIS_ERR_ADRESSE                  =	"Docsis modem address is not 12 digits hexadecimal"
TFC_MSG_DOCSIS_ERR_ADRESSE_BDD				=	"Docsis modem read address %s is different of Database read adress %s"
TFC_MSG_EMTA_ERR_ADRESSE_BDD				=	"EMTA computed mac adress %s is different of Database read adress %s"
TFC_MSG_SSID_ERR_LECTURE					=	"SSID read failure - SSID check not done"
TFC_MSG_SSID_ERR_BDD						=	"SSID read %s is different of Database read SSID %s"
TFC_MSG_SSID_ERR_MASQUE						=	"SSID read in STB : %s does not begin with %s"
TFC_MSG_ECRAN_ERR                           =	"Screen operation KO"
TFC_MSG_VISION_FRONTS_ERR                   =	"Incorrect Front Number (Vision dll retur : %d)"
TFC_MSG_NIM_ERR_SN                          =	"SnCie read in Nim: %s is different from SnCie in Stb: %s"
TFC_MSG_NIM_ERR_VAR_SN                      =	"Variable \"etat_DEC_GEN_sSnNIM\" unspecified at BFE"
TFC_MSG_NIM_ERR_SN_INCONNU                  =	"Numserie Nim is unknown"
TFC_MSG_NIM_CIE                             =	"Cie Nim %s %s"
TFC_MSG_NIM_ERR                             =	"NIM in nomenclature is different from current NIM"
TFC_MSG_INFO_VERSION_APPLI                  =	"Application version : %s"
TFC_MSG_INFO_HARDWARE                       =	"Hardware Id : %s"
TFC_MSG_VIDEO_FLUX_ERR                      =	"Flow not present"
TFC_MSG_VENTILO_CAPTEUR_OK                  =	"Sensor present"
TFC_MSG_VENTILO_CAPTEUR_KO                  =	"Sensor not present, Fan test cannot be done"
TFC_MSG_VENTILO_CAPTEUR_ERREUR              =	"Sensor error, Fan test cannot be done"
TFC_MSG_VENTILO_OK                          =	"Fan detected with correct orientation"
TFC_MSG_VENTILO_SENS_KO                     =	"Fan has bad orientation"
TFC_MSG_VENTILO_PRESENCE_KO                 =	"Fan not powered"
TFC_MSG_GET_STB_INFO_VERSION_APPLI          =	"Application version configured in database:%s is different from version detected in the set top box:%s"
TFC_MSG_GET_STB_INFO_VERSION_HARDWAREID     =	"HardwareId version configured in database:%s is different from version detected in the set top box:%s"
TFC_MSG_INITIALISATION_SWITCH_OK            =   "Switch Initialization OK"
TFC_MSG_LECTURE_VERSION_OK                  =   "TT version OK"
TFC_MSG_LECTURE_SN_OK                       =   "SN OK"
TFC_MSG_VERIF_VERSION_FIRMWARE_OK           =   "verification firmware version OK"
TFC_MSG_VERIF_VERSION_FIRMWARE_KO           =   "verification firmware version KO"
TFC_MSG_INITIALISATION_OK        	    =   "Initialisation OK"
TFC_MSG_DRIVER_2G_KO                        =   "Driver 2G KO"
TFC_MSG_DRIVER_5G_KO                        =   "Driver 5G KO"
TFC_MSG_TEST_BOUTON_OK        	            =   "Button Test OK"
TFC_MSG_Configuration_IR_OK       	    =   "IR configuration OK"
TFC_MSG_Configuration_IR_KO       	    =   "IR configuration KO"
TFC_MSG_TEST_IR_OK       	            =   "IR TEST OK"
TFC_MSG_TEST_IR_KO       	            =   "IR TEST KO"
TFC_MSG_TEST_LED_OK       	            =   "LED TEST OK"
TFC_MSG_Configuration_2G_OK   	            =   "2.4 Ghz configuration OK"
TFC_MSG_Configuration_2G_KO                 =   "Error in configuartion 2.4 GHz"
TFC_MSG_Mesures_2G_OK                       =   "Wifi Measure 2.4 Ghz OK"
TFC_MSG_ERREUR_Nbre_NUM_SWITCH_2G           =   "The number of values in the conf Switch numbers is different from the number of 2G antennas! Can't get the Switch numbers"
TFC_MSG_ERREUR_SWITCH_PORT_SP8T             =   "problem Switch port SP8T !!!"
TFC_MSG_ERREUR_ACTIVATION_2G                =   "2G wifi activation error"          
TFC_MSG_ERREUR_CONFIGURATION_POWERMETER     =   "Error Configuration powermetter"
TFC_MSG_ERREUR_CONFIGURATION_BDD            =   "Error Configuration BDD"     
TFC_MSG_ERREUR_MESURE_2G                    =   "Error Measurement 2G Antenne %d"
TFC_MSG_ERREUR_NBRE_ANTENNES_2G             =   "No 2G antenna measurements (0 antenna number in TCM)"
TFC_MSG_ERREUR_CONF_2G_NON_EXIST            =   "conf_DEC_BNFT_CMD_ACTIVE_ANNT_2G doesn't exist"
TFC_MSG_Configuration_5G_OK   	            =   "5 GHz configuration OK"
TFC_MSG_Configuration_5G_KO                 =   "Error in configuartion 5 GHz"
TFC_MSG_Mesures_5G_OK                       =   "Wifi Measure 5 GHz OK"
TFC_MSG_ERREUR_Nbre_NUM_SWITCH_5G           =   "The number of values in the conf Switch numbers is different from the number of 5G antennas! Can't get the Switch numbers"
TFC_MSG_ERREUR_ACTIVATION_5G                =   "5G wifi activation error"          
TFC_MSG_ERREUR_MESURE_5G                    =   "Error Measurement 5G Antenne %d"
TFC_MSG_ERREUR_NBRE_ANTENNES_5G             =   "No 5G antenna measurements (0 antenna number in TCM)"
TFC_MSG_ERREUR_CONF_5G_NON_EXIST            =   "conf_DEC_BNFT_CMD_ACTIVE_ANNT_5G doesn't exist"
TFC_MSG_Configuration_BT_OK   	            =   "BT configuration OK"
TFC_MSG_Configuration_BT_KO                 =   "Error in configuartion BT"
TFC_MSG_Mesures_BT_OK                       =   "Wifi Measure BT OK"
TFC_MSG_ERREUR_Nbre_NUM_SWITCH_BT           =   "The number of values in the conf Switch numbers is different from the number of BT antennas! Can't get the Switch numbers"
TFC_MSG_ERREUR_ACTIVATION_BT                =   "BT wifi activation error"          
TFC_MSG_ERREUR_MESURE_BT                    =   "Error Measurement BT Antenne %d"
TFC_MSG_ERREUR_NBRE_ANTENNES_BT             =   "No BT antenna measurements (0 antenna number in TCM)"
TFC_MSG_ERREUR_CONF_BT_NON_EXIST            =   "conf_DEC_BNFT_CMD_ACTIVE_ANNT_BT doesn't exist"
TFC_MSG_FINALISATION_OK                     =   "Finalization OK"
TFC_MSG_FINALISATION_KO                     =   "Finalization KO"
TFC_MSG_ERREUR_CONF_Finalisation_NON_EXIST  =   "conf_DEC_BNFT_FINALISATION doesn't exist"
TFC_MSG_TRACABILITE_OK                      =   "Traceability OK"
TFC_MSG_TRACABILITE_KO                      =   "Traceability KO"
TFC_MSG_PERTE_PROMPT_OK                     =   "Prompt Loss OK"
TFC_MSG_PERTE_PROMPT_KO                     =   "Prompt Loss KO"             
TFC_MSG_ERREUR_BRANCHEMENT_POWERMETER       =   "Check USB powermetter connection %s !!"  
TFC_MSG_ERREUR_TYPE_POWERMETER              =   "Powermetter configuration error: Type allowed =  USB %s !!"
TFC_MSG_ATTENTE_PING                        =   "Waiting Ping Switch"



FCT_MSG_CODE_PRODUIT_EXISTE_DIFFERENT       =	"Chosen SFIN product code: %s is different from existing SFIN product code: %s"
FCT_MSG_GENE_SN_VIDE_NOGENE                 =	"SN is empty, no SN was generated"
FCT_MSG_GENE_SN_UNDEF_BYT                   =	"Cannot generate SN Bouygues : variable \'%s\' is not defined"
FCT_MSG_GENE_SN_UNDEF_CHILI                 =	"Cannot generate SN Chili : variable \'%s\' is not defined"
FCT_MSG_GENE_CODEMATERIEL_UNDEF             =	"Cannot generate Hardware code : variable \'%s\' is not defined"
FCT_MSG_GENE_SN_UNDEF_VODA                  =	"Cannot generate SN Vodaphone : variable \'%s\' is not defined"
FCT_MSG_GENE_SN_UNDEF_CYFRA                 =	"Cannot generate SN Cyfra+ : variable \'%s\' is not defined"
FCT_MSG_GENE_SN_UNDEF_DSI87                 =	"Cannot generate SN DSI87 HD SFR : variable \'%s\' is not defined"
FCT_MSG_GENE_SN_UNDEF_M45                   =	"Cannot generate SN M45 : variable \'%s\' is not defined"
FCT_MSG_GENE_SN_UNDEF_IAD84HA               =	"Cannot generate SN IAD84 Hansenet : variable \'%s\' is not defined"
FCT_MSG_GENE_SN_UNDEF_DIGITURK              =	"Cannot generate SN Digiturk : variable \'%s\' is not defined"
FCT_MSG_GENE_SN_CLIENT                      =	"Cannot generate customer serial number \'%s\' : variable \'%s\' is not defined"
FCT_MSG_TRACABDD_STRING                     =	"DBTracking : %s\n"
FCT_MSG_PASS_KO_BDD_SNCIE                   =	"Saving Tests KO in DB for SN CIE: %s\n"
FCT_MSG_NO_START                            =	"No recording on Traceability : Start was not done on Pfin SFC"
FCT_MSG_TRACABDD_KO_STRING                  =	"DNtracking KO : %s"
FCT_MSG_SN_TESTENCOURS                      =	"This SN CIE is currently under test on the other slot!"
FCT_MSG_MAUVAISE_VERSION_CIE                =	"The CIE version in DB (%s) is different from the set top box version (%s)"
FCT_MSG_VERSION_CIE_PASENFLASH              =	"The CIE version is not written in flash"
FCT_MSG_MAUVAIS_INDICE_CIE                  =	"The CIE index in DB (%s) is different from the set top box index (%s)"
FCT_MSG_INDICE_CIE_PASENFLASH               =	"The CIE index is not written in flash"
FCT_MSG_MAUVAIS_MASQUE_CIE                  =	"The CIE SN masks in DB (%s)are different from the set top box CIE SN masks (%s)"
FCT_MSG_SERIAL_CIE_PASENFLASH               =	"The CIE serial number is not written in flash"
FCT_MSG_MAUVAIS_LOADER                      =	"The loader version in DB (%s) is different from the set top box loader version (%s)"
FCT_MSG_MAUVAISE_NOMENCLATURE_HARD          =	"The hardware nomenclature in DB (%s) is different from the set top box hardware nomenclature (%s)"
FCT_MSG_MAUVAISE_NOMENCLATURE_BOOT          =	"The boot nomenclature in DB (%s) is different from the set top box boot nomenclature (%s)"
FCT_MSG_MAUVAISE_FULL_SALES_TYPE            =	"The Full Sales Type in DB (%s) is different from the set top box boot Full Sales Type (%s)"
FCT_MSG_SN_CIE_STRING                       =	"SN CIE : %s"
FCT_MSG_TEST_AUTORISATION                   =	"Testing Authorization : %s"
FCT_MSG_PASSAGE_NON_AUTORISE                =	"Not Authorized"
FCT_MSG_VERIF_FLASH_LOCKE                   =	"Verifying if flash is locked"
FCT_MSG_CRYPTAGE_DONNEES_HDD                =	"Encrypting HDD data"
FCT_MSG_CRYPTAGE_DONNEES_HDD_INHIBE         =	"Encrypting HDD data inhibited : REFERENCE card"
FCT_MSG_ECRITURE_SN_SAGEM                   =	"Writing SN Sagem"
FCT_MSG_ECRITURE_SN_SSL                     =	"Writing SSL certificate Serial number"
FCT_MSG_PASDECRITURE_SNCLIENT               =	"Writing of Customer Serial Number in Flash desactivated"
FCT_MSG_ECRITURE_SN_BYT                     =	"Writing SN Bouygues"
FCT_MSG_ECRITURE_SN_VODA                    =	"Writing SN Vodaphone"
FCT_MSG_PASDECRITURE_SN_CYFRA               =	"SN Cyfra+ Not written"
FCT_MSG_PASDECRITURE_SN_CHILI               =	"SN Telefonica Chili Not written"
FCT_MSG_ECRITURE_SN_DSI87                   =	"Writing SN DSI87 HD SFR"
FCT_MSG_ECRITURE_SN_DIGITURK                =	"Writing SN Digiturk"
FCT_MSG_ECRITURE_SN_CLIENT                  =	"Writing SN %s"
FCT_MSG_ECRITURE_BADBLOCKS                  =	"Writing Bad Blocks number"
FCT_MSG_DESACTIVATION_ETHERNET              =	"Deactivating Ethernet"
FCT_MSG_ECRITURE_DES_CLES                   =	"Writing keys"
FCT_MSG_ECRITURE_SETMAC_DOCSIS              =	"Writing SetMac Docsis"
FCT_MSG_TEST_WAKEONLAN                      =	"Wake on Lan test"
FCT_MSG_MAJ_PROPRIETES_DEBUT                =	"Start: properties update"
FCT_MSG_MAJ_PROPRIETES_FIN                  =	"End: properties update"
FCT_MSG_FILTRE_UNICITE                      =	"Uniqueness violation filter"
FCT_MSG_ECRITURE_WRITETRACKING              =	"Writing WriteTracking"
FCT_MSG_SECURISATION                        =	"Product Securization"
FCT_MSG_TRACABILITE_MESURE                  =	"Recording Measures in Traceability"
FCT_MSG_TRACABILITE_HDD                     =	"Recording of HDD Data in Traceability"
FCT_MSG_TRACABILITE_COLLECT                 =	"Collecting STB data in Traceability"
FCT_MSG_TRACABILITE_ASSEMBLE                =	"Assembling STB data in Traceability"
FCT_MSG_ECRITURE_WRITETRACKING_INHIBE       =	"Writing WriteTracking inhibited : REFERENCE card"
FCT_MSG_ECRITURE_FLASH_SKIPPE               =	"Writing in flash skipped according to compilation"
FCT_MSG_CIE_SN_NON_REMONTE                  =	"CIE SN is not read"
FCT_MSG_CIE_INDICE_NON_REMONTE              =	"CIE index is not read"
FCT_MSG_CIE_CODE_PRODUIT_NON_REMONTE        =	"CIE product code is not read"
FCT_MSG_LOADER_NON_REMONTE                  =	"loader is not read"
FCT_MSG_TT_NON_REMONTE                      =	"TT is not read"
FCT_MSG_NOMENCLATURE_HW_NON_REMONTE         =	"hardware nomenclature is not read"
FCT_MSG_NOMENCLATURE_BOOT_NON_REMONTE       =	"boot nomenclature is not read"
FCT_MSG_FULL_SALES_TYPE_NON_REMONTE         =	"Full Sales Type is not read"
FCT_MSG_VARIABLE_STRING_NON_DEFINIE         =	"Variable \"%s\" is not defined"
FCT_MSG_ERR_RECUP_VAR_TRACA                 =	"Error retreiving tracking variables"
FCT_MSG_ERR_CMDTT_TIMEOUT                   =	"Error TT command (%s) : time out"
FCT_MSG_ERR_CMDTT_FAIL                      =	"Error TT command (%s) : fail found"
FCT_MSG_ERR_CMDTT_NON_TROUVE_STRING         =	"Error TT command (%s) : tag not found (%s)"
FCT_MSG_ERR_CMDTT_STRING                    =	"Error TT command (%s) : %s"
FCT_MSG_ERR_CMDTT_ECHO1                     =	"Error on echo control : buffer overflow"
FCT_MSG_ERR_CMDTT_ECHO2                     =	"Error on echo control (not found) for TT command."
FCT_MSG_ERR_CMDTT_ECHO3                     =	"Error on echo control (not found) for TT command : %s"
FCT_MSG_CMDTT_ECHO_NO_AFF                   =	"Command not shown"
FCT_MSG_CMDTT_ECHO_OK                       =	"Echo control OK for TT command : %s"
FCT_MSG_CHECK_NUMBER_STRING                 =	"Check Number : %s"
FCT_MSG_ERREUR_DE_COM                       =	"Communication error"
FCT_MSG_DIFF_CHIPSETID_MASQUE               =	"Chipset Id different from mask"
FCT_MSG_ERR_LECT_UNIQUEID_STRING            =	"Error FCT_LectureUniqueId : %s"
FCT_MSG_ERR_LECT_FLASH_ID_STRING            =	"Erreur Reading Flash Device ID : %s"
FCT_MSG_ERR_LECT_CHIP_IDENT_STRING          =	"Erreur Reading Chipset ST IDENT : %s"
FCT_MSG_LIST_CIE_NOM                        =	"<CIE>  Name                               : %s\n"
FCT_MSG_LIST_CIE_REF                        =	"<CIE>  Reference                          : %s\n"
FCT_MSG_LIST_CIE_IND                        =	"<CIE>  Index                              : %s\n"
FCT_MSG_LIST_SFIN_NOM                       =	"<SFIN> Name                               : %s\n"
FCT_MSG_LIST_SFIN_REF                       =	"<SFIN> Reference                          : %s\n"
FCT_MSG_LIST_SFIN_IND                       =	"<SFIN> Index                              : %s\n"
FCT_MSG_LIST_PFIN_NOM                       =	"<PFIN> Name                               : %s\n"
FCT_MSG_LIST_PFIN_REF                       =	"<PFIN> Reference                          : %s\n"
FCT_MSG_LIST_PFIN_IND                       =	"<PFIN> Index                              : %s\n"
FCT_MSG_OUVRIR_FICHIER_IMPOSSIBLE           =	"Cannot open file \'%s\' "
FCT_MSG_CREER_FICHIER_IMPOSSIBLE            =	"Cannot create file \'%s\' "
FCT_MSG_RESULT_SFC_PFIN                     =	"Pfin SFC SAP ME                           : %s\n"
FCT_MSG_RESULT_SFC_CIU                      =	"Ciu SFC SAP ME                            : %s\n"
FCT_MSG_SAPME_REF_CMS                       =	"CMS Production Order of Ciu SFC           : %s\n"
FCT_MSG_SAPME_TYPE_CMS                      =	"<SAPME> CMS Production Order Type         : %s\n"
FCT_MSG_SAPME_REF_INTEG                     =	"Integ. Production Order of Pfin SFC       : %s\n"
FCT_MSG_SAPME_TYPE_INTEG                    =	"<SAPME> Integ. Production Order Type      : %s\n"
FCT_MSG_RESULT_SN_CIE                       =	"CIE SN in STB flash                       : %s\n"
FCT_MSG_RESULT_VERSION_CIE                  =	"CIE Version in STB flash                  : %s\n"
FCT_MSG_RESULT_INDICE_CIE                   =	"CIE Indice in STB flash                   : %s\n"
FCT_MSG_RESULT_POSTE_TRACACOM               =	"Tracacom Workstation                      : %s\n"
FCT_MSG_RESULT_OPR_POSTE_SAP_ME             =	"SAP ME Workstation Operation              : %s\n"
FCT_MSG_RESULT_RSC_POSTE_SAP_ME             =	"SAP ME Workstation Ressource              : %s\n"
FCT_MSG_RESULT_OPR_PRINT_SAP_ME             =	"SAP ME Printing Operation                 : %s\n
FCT_MSG_RESULT_RSC_PRINT_SAP_ME             =	"SAP ME Printing Ressource                 : %s\n"
FCT_MSG_RESULT_CHIPSET_ID                   =	"Chipset ID (decimal)                      : %s\n"
FCT_MSG_RESULT_CODE_AUTORISATION            =	"Authorization code                        : %d\n"
FCT_MSG_RESULT_LIBELLE_ERREUR               =	"Error label                               : %s\n"
FCT_MSG_ERR_CREATION_CMDTT                  =	"Error creating CmdTT"
FCT_MSG_ERR_DYNMEMINFO                      =	"DynamicMemoryInfo"
FCT_MSG_ERR_POSTE_SLOT                      =	"Station: %s Slot: %d Error: %s"
FCT_MSG_ERR_MESSAGE                         =	"Message: %s\nSn Cie: %s\nCie Product code: %s\nCie index: %s\n"
FCT_MSG_ERR_ENVOI_EMAIL                     =	"Sending e-mail"
FCT_MSG_TT_CLIENT_NON_REMONTE               =	"Customer TT is not read"
FCT_MSG_ADR_BASE_TRACA_NON_REMONTE          =	"Tracking Adress is not read"
FCT_MSG_HARDWARE_ID_NON_REMONTE             =	"Hardware Id is not read"
FCT_MSG_USAGE_ID_NON_REMONTE                =	"Usage Id is not read"
FCT_MSG_SFIN_SN_NON_REMONTE                 =	"Sn Sfin is not read"
FCT_MSG_ERR_PROVIS_C_PLUS                 	=	"The C+ product provisioning configuration is not valid."
WRT_MSG_NAGRA_UNIQUE_ID_PB_LEN              =	"Pb NAGRA_Unique_ID(hex) length"
WRT_MSG_NAGRA_UNIQUE_ID_PB_FMT              =	"Pb NAGRA_Unique_ID(hex) format"
WRT_MSG_NAGRA_UNIQUE_ID_PB_SN               =	"Chipset Sn is different from Nagra Unique Id"
WRT_MSG_NAGRA_STB_CA_SN_PB_FMT              =	"Pb STB_CA_serial_number(hex) format"
WRT_MSG_NAGRA_CRC_PB_FMT                    =	"Pb NAGRA_CRC(hex) format"
WRT_MSG_CHECK_NUMBER_PB_FMT                 =	"Pb Check_Number(hex) format"
WRT_MSG_CSCDATA_CHECK_NUMBER_PB_FMT         =	"Pb CSCData_CheckNumber(hex) format"
WRT_MSG_ERR_WRITENAGRALOG                   =	"Error WriteNagraLog : %s"
WRT_MSG_ERR_WTR_SN                          =	"Error WTR_SerialNumber : %s"
WRT_MSG_ECRITURE_SN_FIN                     =	"End writing Serial number : OK"
WRT_MSG_ERR_DOCSIS                          =	"Error STB MAC address : read = %s, expected = %s"
WRT_MSG_DOCSIS                              =	"STB MAC address is the same as Docsis MAC address "
WRT_MSG_ECRITURE_DOCSIS_SETMAC_ERR          =	"Error Docsis MAC address"
WRT_MSG_ECRITURE_DOCSIS_SETMAC_FIN          =	"End writing Docsis MAC address : OK"
WRT_MSG_FLASH_VERIF_LOCK                    =	"Verifying flash locking"
WRT_MSG_FLASH_PAS_LOCKEE                    =	"Flash is NOT locked!!\n"
WRT_MSG_FLASH_BIEN_LOCKEE                   =	"Flash is locked\n"
WRT_MSG_FLASH_LOCK_PWD_GENERIC              =	"Flash is locked with a generic password\n"
WRT_MSG_FLASH_PASSER_PWD                    =	"Pass the password \n"
WRT_MSG_FLASH_DELOCK_OK_FIN                 =	"End delocking flash : OK"
WRT_MSG_FLASH_PASSAGE_PWD                   =	"Passing password to lock flash"
WRT_MSG_FLASH_LOCKAGE_OK                    =	"Flash locking : OK"
WRT_MSG_FLASH_LOCKAGE                       =	"Locking Flash"
WRT_MSG_FLASH_VERIF_AFTER_STD               =	"Verifying if flash locked"
WRT_MSG_ERREUR_CLE_STB                      =	"Writing stbpasswords key in database"
WRT_MSG_CHIPSET_NON_SECURSIE                =	"CHIPSET IS NOT SECURED"
WRT_MSG_CHIPSET_EST_SECURISE                =	"CHIPSET IS SECURED"
WRT_MSG_CRYPTAGE_HDD                        =	"WTR_CryptageDisqueDur : %s"
WRT_MSG_ETH_FERMETURE_PORT                  =	"Closing Ethernet port\n"
WRT_MSG_ETH_DESACTIVER                      =	"Deactivating Ethernet : %s"
WRT_MSG_ECRITURE_HW_ID                      =	"Writing Hardware_id : %s"
WRT_MSG_ECRITURE_MAN_ID                     =	"Writing Manufactured_ID : %s"
WRT_MSG_ECRITURE_HW_VERSION                 =	"Writing Version Hardware : %s"
WRT_MSG_ECRITURE_DWNLD_ID                   =	"Writing Download_id : %s"
WRT_MSG_ECRITURE_IP_SERVEUR_DL              =	"Writing download server IP : %s "
WRT_MSG_ECRITURE_FICHIER_DL                 =	"Writing file to download ==> CHEMIN_TELECHARGEMENT"
WRT_MSG_CRYPTAGE_FLUX_DL                    =	"Encrypting download flow"
WRT_MSG_ERREUR_TT_FINALISATION              =	"Error in set top box finalization command"
WRT_MSG_ACTIVE_CUSTOM_PRERECETTE            =	"Error activating custom boot in pre-checkout"
WRT_MSG_ACTIVE_CUSTOM_UNDEF                 =	"Variable [etat_DEC_BPO_bFlagActiverPreReset] is not defined"
WRT_MSG_SWITCH_TT_PANA                      =	"Switch to TT Panasonic"
WRT_MSG_FORCAGE_TT_TO_APPLI                 =	"Forcing switch TT -> Appli"
WRT_MSG_FORCAGE_TELECHARGEMENT              =	"Forcing download"
WRT_MSG_EFFACE_ZONE_TT                      =	"Deleting TT zone"
WRT_MSG_CHIPSET_PAIRING                     =	"Chipset pairing"
WRT_MSG_LOCKAGE_JTAG                        =	"Locking JTAG"
WRT_MSG_ACTIVE_CRYPTOCORE                   =	"Cryptocore activation"
WRT_MSG_FUSIBLE_DRM                         =	"DRM Fuse"
WRT_MSG_ERREUR_WRITETRACKING                =	"Error WriteTracking : %s"
WRT_MSG_ERREUR_SECURISATION                 =	"Error Securization : %s"
WRT_MSG_ERREUR_WTR_SSLSN                    =	"Error WTR_SslCertificateSerialNumber : %s"
WRT_MSG_ECRITURE_SSLSN_FIN                  =	"End writing SSL certificate serial number : OK"
WRT_MSG_FUSES_ERREUR_VERIF                  =	"FUSE ERROR: the expected pattern [%s] state is %s instead of %s"
WRT_MSG_FUSES_CONFIRM_VERIF                 =	"FUSE INFO: the pattern [%s] state is %s, as expected"
WRT_MSG_FUSES_ACTIV_OK                      =	"FUSE INFO : Verification of activated Fuses is OK"
WRT_MSG_FUSES_ACTIV_SKIPPE                  =	"FUSE INFO : No list given for activated Fuses verification... Verification skipped"
WRT_MSG_FUSES_DESACTIV_OK                   =	"FUSE INFO : Verification of not-activated Fuses is OK"
WRT_MSG_FUSES_DESACTIV_SKIPPE               =	"FUSE INFO : No list given for not-activated Fuses verification... Verification skipped"
WRT_MSG_STATUS_JTAG                         =	"Get Fuse Status JTAG: %s"
WRT_MSG_STATUS_DSC                          =	"Get Fuse Status DSC: %s"
WRT_MSG_STATUS_CW                           =	"Get Fuse Status CW Secure: %s"
WRT_MSG_FUSIBLE_MES                         =	"Activating MES"
WRT_MSG_PWD_FLASH_KO                        =	"Password Protection KO"
WRT_MSG_PWD_FLASH_OK                        =	"Password Protection OK"
WRT_MSG_NOVERIF_PWD_FLASH                   =	"WARNING: Password flash check unactivated"
WRT_MSG_SECTEUR_FLASH_LOCK_KO               =	"Zone n°%i Area n°%i UNLocked"
WRT_MSG_SECTEUR_FLASH_LOCK_OK               =	"Zone n°%i Area n°%i Locked"
WRT_MSG_PROP_SFIN                           =	"the propertie linked to SFIN [%s] is not configured"
TNT_BBX_MSG_INIT                            =	"BBX_Initialize = %d\n"
TNT_BBX_MSG_WARNING                         =	"Warning (%d)\n"
TNT_BBX_MSG_ERREUR                          =	"Error (%d)\n"
TNT_BBX_MSG_TERMINATE                       =	"BBX_Terminate = %d\n"
TNT_BBX_MSG_NEW_STB                         =	"------- New Set Top Box : NS=%s, Id=%s ------\n"
TNT_BBX_MSG_CONNECT_ID                      =	"BBX_Connect = %d (sessionId %d)\n"
TNT_BBX_MSG_DIAGNOSTIC                      =	"BBX_Diagnostic = %d\n"
TNT_BBX_MSG_NVM_PREPARE                     =	"BBX_PrepareNvm = %d\n"
TNT_BBX_MSG_NVM_GET                         =	"BBX_GetNvm = %d\n"
TNT_BBX_MSG_DISCONNECT                      =	"BBX_Disconnect\n"
TNT_BBX_MSG_TEMPS                           =	"time = %fs\n"
TNT_BBX_MSG_NVM_LIT_CLE                     =	"TNTClesPerso_BBX_LitCleNVM"
TNT_BBX_MSG_DIAGNOSTIC_TITRE                =	"------- Black Box serveur analysis  ------\n"
TNT_BBX_MSG_DIAGNOSTIC_CMD                  =	"TNTClesPerso_BBX_Diagnostic"
TNT_BBX_MSG_NVM_ANNULE_TITRE                =	"------- NVM Key cancelation : Id=%s------\n"
TNT_BBX_MSG_NVM_CANCEL                      =	"BBX_CancelNvm = %d\n"
TNT_BBX_MSG_STRING_TO_BCD                   =	"StringToBCD"
TNT_BBX_MSG_PREPARE_CHIPSET_ID              =	"PrepareChipSetId"
TNT_BBX_MSG_NO_ERR_MSG                      =	"No BBX_message corresponding to the returned error code"
TNT_BBX_MSG_WARNING_NO_FCT_CALL             =	"Warning The \"BBX_Initialize\" function has already been called. This new call will have no effect"
TNT_BBX_MSG_WARNING_CHIPSET_UNKNOWN         =	"Warning The ChipsetId is unknown of the BlackBox. The computation isn't started, the connection is kept opened, and new computation requests can be done"
TNT_BBX_MSG_WARNING_NO_COMPUTATION          =	"Warning No computation has been requested for this ChipsetId. The function has no effect"
TNT_BBX_MSG_WARNING_PROJECTID_UNKNOWN       =	"Warning The ProjectId is unknown of the BlackBox. The computation isn't started, the connection is kept opened, and new computation requests can be done"
TNT_BBX_MSG_WARNING_COMPUTATION_DONE        =	"Warning A computation request has already been done for this ChipsetId, and the Serial Number was different. The computation isn't started, the connection is kept opened, and new computation requests can be done"
TNT_BBX_MSG_WARNING_WAIT_RESPONSE           =	"Warning The response has not been received by the client. The server has not finished the computation. So the user of the library will have to call the function again a little later"
TNT_BBX_MSG_WARNING_COMPUTATION_LOST        =	"Warning The response has not been received by the client, but the maximum waiting time has been reached. The server has not finished the computation, but we consider the computation lost, and the response will never be received"
TNT_BBX_MSG_WARNING_WRONG_NVM_SIZE          =	"Warning The real size of the NVM returned by the server is greater than the size of the buffer. The function can't return the NVM to its caller. The caller can call this function again, until the time-out of the computation."
TNT_BBX_MSG_ERROR_INIT_LIBRARY              =	"Error The library must first be initialized. The client can't do anything before initialization"
TNT_BBX_MSG_ERROR_CLIENT_CANT_LOAD          =	"Error Neither the parameters to the \"BBX_Initialize\" function, nor the BBX_HOME variable are defined. The client can't load its configuration and won't be able to open connections to the server"
TNT_BBX_MSG_ERROR_NO_CONFIG_FILE            =	"Error Configuration file not found. The client can't load its configuration and won't be able to open connections to the server"
TNT_BBX_MSG_ERROR_CANT_READ_CONFIG          =	"Error Configuration file can't be read or interpreted. The client can't load its configuration and won't be able to open connections to the server"
TNT_BBX_MSG_ERROR_CANT_CONNECT              =	"Error The client can't connect to the server"
TNT_BBX_MSG_ERROR_CONNECTION_LOST           =	"Error The connection has been lost"
TNT_BBX_MSG_ERROR_MAX_CONNECTIONS           =	"Error Maximum number of connections reached. The connection is closed by the server, next to the transmission of the response"
TNT_BBX_MSG_ERROR_BAD_PROTOCOL              =	"Error The server doesn't know the protocol version asked by the BlackBox. The connection is closed by the server, next to the transmission of the response"
TNT_BBX_MSG_ERROR_UNKNOWN_SESSION_ID        =	"Error The sessionID given in the header is unknown. The computation isn't started, and the connection is closed by the server, next to the transmission of the response"
TNT_BBX_MSG_ERROR_INTERNAL                  =	"Error Internal Error See server logs for more informations"
TNT_BBX_MSG_ERROR_CANT_TERMINATE            =	"Error Connections are still opened. The termination can't be done (<=> operation cancelled)"
TNT_BBX_MSG_ERROR_INVALID_PARAMETER         =	"Error One or more parameters are invalid (null pointers). The operation can't be done (<=> operation cancelled)"
TNT_BBX_MSG_ERROR_NO_ERROR                  =	"No error"
TNT_BBX_MSG_GETBBXERRORSTRING               =	"GetBBXErrorString"
TNT_BBX_MSG_DISK_STATUS_OK                  =	"Disk Status : Ok\n"
TNT_BBX_MSG_DISK_STATUS_LOW                 =	"Disk Status : the free space is lower than a threshold, configured on server side\n"
TNT_BBX_MSG_DISK_STATUS_FULL                =	"Disk Status : the disk is full\n"
TNT_BBX_MSG_DISK_STATUS_UNKNOWN             =	"Disk Status : valeur de parametre inconnue\n"
TNT_BBX_MSG_RAID_STATUS_OK                  =	"Raid Disk Status : Ok\n"
TNT_BBX_MSG_RAID_STATUS_NOREDUNDANT         =	"Raid Disk Status : the disks are no more redundant\n"
TNT_BBX_MSG_RAID_STATUS_UNKNOWN             =	"Raid Disk Status : valeur de parametre inconnue\n"
TNT_BBX_MSG_POWER_STATUS_OK                 =	"Power Status : Ok\n"
TNT_BBX_MSG_POWER_STATUS_NOREDUDANT         =	"Power Status : the power supplies are no more redundant\n"
TNT_BBX_MSG_POWER_STATUS_UNKNOWN            =	"Power Status : valeur de parametre inconnue\n"
TNT_BBX_MSG_FAIL_STATUS_OK                  =	"Fail Over Status : Ok\n"
TNT_BBX_MSG_FAIL_STATUS_DOWN                =	"Fail Over Status : one of the servers is down\n"
TNT_BBX_MSG_FAIL_STATUS_UNKNOWN             =	"Fail Over Status : valeur de parametre inconnue\n"
TNT_BBX_MSG_GETBBXDIAGSTRING                =	"GetBBXDiagString"
TNT_BBX_MSG_NVM_TRACE                       =	"trace"