[MESSAGES]
IHM_STR_ERREUR				    =	">>ERREUR>> %s\n"
TCOM_MESSAGE_ERREUR_RESEAU                  =	"Time out"
PNL_INTIT_TEXT                              =	"Sélection Intitulé Produit"
PNL_INTIT_ANNULER_TEXT                      =	"__Annuler"
PNL_INTIT_VALIDER_TEXT                      =	"__Valider"
PNL_INTIT_SLIDE_TEXT                        =	"Patienter Initialisation de la carte DIO ..."
PNL_INTIT_SLIDE_TEXT_PRODUCT                =	"Récupération Choix Produit (%d sur %d produits) ..."
PNL_INTIT_FILTRE                            =	"Filtre"
PNL_MAIN_TEXT                               =	"Personnalisation STB"
PNL_MAIN_LIB_SLOT_TEXT                      =	"Libere Slot"
PNL_MAIN_FERME_SLOT_TEXT                    =	"Ferme Slot"
PNL_MAIN_TEST_PRINT_SLOT_TEXT               =	"Stb Sticker"
PNL_MAIN_BT_TRACA_SLOT_TEXT                 =	"Traca"
PNL_MAIN_BT_CONFIG_TEXT                     =	"__Config"
PNL_MAIN_TOP_PROD_TEXT                      =	"Validation"
PNL_MAIN_ACTIVE_LOG_TEXT                    =	"Activation LOG"
PNL_MAIN_TXT_INFO2_TEXT                     =	"Message..."
PNL_MAIN_TXT_RESULT_TEXT                    =	"DECODEUR VALIDE"
PNL_MAIN_SLOT_TEXT                          =	"SLOT1"
PNL_VAR_TXT_TRACA_TEXT                      =	"GESTION DES VARIABLES"
PNL_VAR_STR_FILTRE_TEXT                     =	"Filtre:"
PNL_VAR_CHK_FILTRE_TEXT                     =	"Variables Configurées"
PNL_VAR_BTN_DEFAUT_TEXT                     =	"__Défaut"
PNL_VAR_BTN_SAVE_TEXT                       =	"__Sauvegarder"
PNL_VAR_BTN_QUIT_TEXT                       =	"__Quitter"
PNL_BOUTON_TXT_INFO_ECRAN_OK_TEXT           =	"Ecran OK => Appuyer sur bouton vert"
PNL_BOUTON_TXT_INFO_ECRAN_KO_TEXT           =	"Ecran KO => Appuyer sur bouton rouge"
PNL_BOUTON_TXT_INFO_TEXT                    =	"APPUYEZ SUR LE BOUTON %d"
PNL_BOUTON_TXT_INFO_TEXT_HDD                =	"Retirez le HDD puis appuyer sur bouton vert"
PNL_BOUTON_TXT_INFO_TEXT_ECRAN              =	"Si Ecran OK => Appuyer sur bouton vert"
PNL_INFO_TXT_MSG_CARD_RETIREZ               =	"\n(Temps Restant : %d s)"
PNL_POPUP_CB_OUI_TEXT                       =	"__OUI"
PNL_POPUP_CB_NON_TEXT                       =	"__NON"
PNL_POPUP_CB_OK_TEXT                        =	"__OK"
PNL_POPUP_TEXT                              =	"Untitled Panel"
PNL_POPUP_TXT_MSG_TEXT                      =	"Text Message"
PNL_PWD_ID                                  =	"Identifiant"
PNL_PWD_PWD                                 =	"Mot de passe"
PNL_TRACA_TEXT                              =	"Paramètres de traçabilité"
PNL_TRACA_TXT_TRACA_TEXT                    =	"VARIABLES DE TRACABILITE"
PNL_TRACA_BTN_ENRG_TEXT                     =	"__Sauvegarder"
PNL_TRACA_BTN_QUIT_TEXT                     =	"__Quitter"
IHM_ATTENTE_DECODEUR                        =	"ATTENTE DECODEUR"
IHM_DECODEUR_DETECTE                        =	"DECODEUR DETECTE"
IHM_ATTENTE_DEMARRAGE_DECODEUR              =	"ATTENTE DEMARRAGE DECODEUR"
IHM_DEPART_TEST                             =	"DEPART TEST"
IHM_VERIFICATION_AUTORISATION_PASSAGE       =	"VERIFICATION DE L'AUTORISATION DE PASSAGE"
IHM_CONNEXION_NAPPE_FUSING                  =	"CONNEXION NAPPE FUSING"
IHM_LANCEMENT_SERVEUR_FTP                   =	"DEMARRAGE SERVEUR FTP"
IHM_LECTURE_CHIPSET_ID                      =	"LECTURE DU CHIPSET ID"
IHM_GENERATION_NUMSERIE                     =	"GENERATION NUMSERIE"
IHM_TEST_HDD                                =	"TEST HDD"
IHM_RETRAIT_HDD                             =	"RETRAIT HDD"
IHM_TEST_PATINS_VIS                         =	"TEST PATINS ET VIS"
IHM_TEST_COULEUR                           =	"TEST CAPTEURS COULEUR"
IHM_TEST_BOUTONS                            =	"TEST BOUTONS"
IHM_TEST_LAME_MASSE                         =	"TEST LAME DE MASSE"
IHM_TEST_INFRAROUGE                         =	"TEST INFRAROUGE"
IHM_TEST_RF                                 =	"TEST RF"
IHM_TEST_RF4CE                              =	"TEST RF4CE"
IHM_TEST_VENTILATEUR                        =	"TEST VENTILATEUR"
IHM_TEST_VENTI_TACHY                        =	"TEST VENTILATEUR TACHYMETRIQUE"
IHM_TEST_CONSOMMATION                       =	"TEST CONSOMMATION"
IHM_TEST_LED_PSOC                           =	"TEST LEDS"
IHM_TEST_SMARTCARD                          =	"TEST SMARTCARD"
IHM_TEST_USB                                =	"TEST USB"
IHM_TEST_SD_CARD                            =	"TEST SD CARD"
IHM_TEST_E_SATA                             =	"TEST E-SATA"
IHM_TEST_BR_HDMI                            =	"TEST BLURAY - HDMI"
IHM_TEST_ECRAN                              =	"TEST ECRAN"
IHM_TEST_VISION_7_SEG                       =	"TEST VISION 7 SEGMENTS"
IHM_TEST_DOCSIS                             =	"TEST DOCSIS"
IHM_TEST_FLASH_NAND                         =	"TEST FLASH NAND"
IHM_TEST_FLASH_NOR                          =	"TEST FLASH NOR"
IHM_TEST_NIM                                =	"TEST NIM"
IHM_TEST_VIDEO                              =	"TEST VIDEO"
IHM_TEST_CHECK_APPLI_TT                     =	"TEST CHECK APPLI & TT"
IHM_TEST_GET_STB_INFO                       =	"TEST RECUPERATION INFOS DECODEUR"
IHM_TEST_CHIPSET_TEMPERATURE                =	"TEST TEMPERATURE CHIPSET"
IHM_ECRITURE_FLASH                          =	"ECRITURE FLASH"
IHM_SECURISATION_TRACA                      =	"SECURISATION ET TRACABILITE PARALLELE"
IHM_TEST_TT_CLIENT                          =	"TEST TT CLIENT"
IHM_TRACA_BDD                               =	"TRACABILITE STB"
IHM_IMPRESSION_ETIQUETTE                    =	"IMPRESSION ETIQUETTE"
IHM_PASSAGE_KO                              =	"PASSAGE KO"
IHM_TEST_FONCTIONNEL_TERMINE                =	"TEST FONCTIONNEL TERMINE"
IHM_PASSAGE_OK                              =	"PASSAGE OK"
IHM_TEST_TERMINE                            =	"TEST TERMINE"
IHM_ATTENTE_RETRAIT_DECODEUR                =	"ATTENTE RETRAIT DECODEUR"
IHM_DECODEUR_VALIDE                         =	"DECODEUR VALIDE"
IHM_DECODEUR_NON_VALIDE                     =	"DECODEUR NON VALIDE"
IHM_SLOT_NUM                                =	"TETE %d"
IHM_MODE_PROTO_SANS_DIO_WATT                =	"Mode Proto :\n-Pas de Statut PROD\n-Pas de DIO"
IHM_MODE_PROTO_SANS_WATT                    =	"Mode Proto :\n-Pas de Statut PROD"
IHM_MODE_PROTO_SANS_DIO                     =	"Mode Proto :\n-Pas de DIO"
IHM_MODE_PROTO                              =	"Mode Proto"
IHM_TTR_POPUP_QST_ETIQUETTE                 =	"Impression Etiquette"
TFC_TTR_POPUP_QST_BOUTON                    =	"Test Boutons"
TFC_TTR_POPUP_QST_IR                        =	"Test Infrarouge"
TFC_TTR_POPUP_QST_ECRAN                     =	"Test Ecrans"
TFC_TTR_POPUP_QST_VIDEO                     =	"Test Video"
HDD_TTR_POPUP_QST_HDD                       =	"Test Retrait HDD"
FCT_TTR_POPUP_INF                           =	"INFORMATION"
FCT_TTR_POPUP_ERR                           =	"ERREUR"
IHM_MSG_POPUP_QST_ETQUETTE                  =	"Imprimer une étiquette de calibration ?\n(NON -> Impression étiquette produit)"
TFC_MSG_POPUP_QST_BOUTON                    =	"Voulez-vous continuer le test des boutons ?\n(non -> Test KO)"
TFC_MSG_POPUP_QST_IR                        =	"Voulez-vous réessayer le test Infrarouge ?\nAppuyer sur un bouton décodeur ou cliquer sur'RETEST'\n pour un nouvel essai - Clic sur 'FAIL' ou Timeout sort en erreur"
TFC_MSG_POPUP_QST_ECRAN                     =	"Voulez-vous continuer les test écran?\n(non -> Test KO)"
TFC_MSG_POPUP_QST_VIDEO                     =	"Appuyer sur OUI si la video est présente"
HDD_MSG_POPUP_QST_HDD                       =	"Voulez-vous continuer le test retrait HDD?\n(non -> Test KO)"
FCT_MSG_POPUP_ERR_PROP_SFIN_NON_DEFINIE     =	">>ERREUR>> la propriété liée au SFIN [%s] n est pas configurée"
FCT_MSG_POPUP_ERR_PROP_CIE_NON_DEFINIE      =	">>ERREUR>> la propriété liée au CIE [%s] n est pas configurée"
FCT_MSG_POPUP_ERR_MES_NON_DEFINIE           =	">>ERREUR>> la mesure liée au CIE [%s] n est pas configurée"
CLE_MSG_POPUP_ERR_MAC_CONSECUTIVES          =	"les adresses mac ne sont pas consécutives"
CLE_MSG_POPUP_ERR_BSK                       =	"le Bsk n est pas compris entre 6 et 9"
SMI_MSG_POPUP_ERR_1                         =	"Erreur: initializes the Cryptoki library"
SMI_MSG_POPUP_ERR_2                         =	"Erreur: opens a session between an application and a token"
SMI_MSG_POPUP_ERR_3                         =	"Erreur: initializes a message-digesting operation"
SMI_MSG_POPUP_ERR_4                         =	"Erreur: digests data in a single part"
SMI_MSG_POPUP_ERR_5                         =	"Erreur: Ecriture clé SCK2"
GENERIQUE_MSG_POPUP_CODE                    =	"Code d'erreur %i : %s\n\n"
GENERIQUE_MSG_POPUP_PRESSE_PAPIER           =	"%s(Message copié vers le presse-papier)"
GENERIQUE_TTR_POPUP                         =	"Erreur initialisation"
GENERIQUE_TTR_POPUP_ERR                     =	"Erreur"
DIO_TTR_POPUP                               =	"ERREUR DIO"
DIO_MSG_POPUP_1                             =	"Configuration identique sur 2 voies DIO détectée : %s et %s"
DIO_MSG_POPUP_2                             =	"Nom de signal introuvable ou format incorrect"
DIO_MSG_POPUP_3                             =	"Numéro de périphérique carte NI PCI-DIO-96 introuvable ou format incorrect"
DIO_MSG_POPUP_4                             =	"Port du signal \"%s\" introuvable ou format incorrect"
DIO_MSG_POPUP_5                             =	"Ligne du signal \"%s\" introuvable ou format incorrect"
DIO_MSG_POPUP_6                             =	"Etat actif du signal \"%s\" introuvable ou format incorrect"
DIO_MSG_POPUP_7                             =	"Sens du signal \"%s\" introuvable ou format incorrect"
DIO_MSG_POPUP_8                             =	"Problème lors du paramétrage d'un signal\n * Paramètres du signal :\n  - nom : %s\n  - périphérique : %d\n  - port : %d\n  - ligne : %d\n  - sens : %d\n  - état actif : %d\n * Code d'erreur retourné : %d\n * Message d'erreur retourné :\n=> %s"
DIO_MSG_POPUP_9                             =	"Section \"%s\" ou lignes introuvables dans le fichier d'initialisation"
ZEB_TTR_POPUP                               =	"ERREUR ZEBRA"
ZEB_MSG_POPUP_5                             =	"Fichier introuvable"
ZEB_MSG_POPUP_6                             =	"Chargement mémoire du fichier impossible"
IHM_WATT_TTR_POPUP                          =	"ERREUR WATTMETRE"
IHM_WATT_MSG_POPUP_1                        =	"\n***!!! Modèle de Wattmetre utilisé non conforme ou absent !!!***"
IHM_WATT_MSG_POPUP_2                        =	"\n***!!! wattmettre en mode WATT KO !!!***"
IHM_WATT_MSG_POPUP_3                        =	"\n***!!! gamme en tension KO !!!***"
IHM_WATT_MSG_POPUP_4                        =	"\n***!!! gamme en courant KO !!!***"
IHM_WATT_MSG_POPUP_5                        =	"\n***!!! mode du wattmetre : annulation du mode automatique  KO !!!***"
IHM_WATT_MSG_POPUP_6                        =	"\n***!!! Configuration impossible (%s) !!!***"
IHM_QUANTUM_TTR_POPUP                       =	"ERREUR QUANTUM DATA"
IHM_QUANTUM_MSG_POPUP_1                     =	"\n***!!! Mauvaise Configuration du Quantum Data - Vérifiez les variables en BDD !!!***"
IHM_COM_TTR_POPUP                           =	"ERREUR PORT COM"
IHM_COM_MSG_POPUP_1                         =	"%s Problème fermeture port COM%i\n\n"
IHM_COM_MSG_POPUP_2                         =	"%s Problème ouverture port COM%i\n\n"
IHM_BTN_TTR_POPUP                           =	"ERREUR PANEL BOUTON"
IHM_BTN_MSG_POPUP_1                         =	"Erreur de chargement de la panel Bouton"
IHM_BTN_MSG_POPUP_2                         =	"Erreur lors de la création d'un Bouton"
IHM_BTN_MSG_POPUP_3                         =	"Nombre de bouton non pris en charge ou configuration incorrecte"
IHM_TTR_POPUP_2                             =	"Erreur configuration CIE"
IHM_TTR_POPUP_3                             =	"Erreur configuration SFIN"
IHM_MSG_POPUP_4                             =	"Problème lors de la récupération du masque étiquette \"%s\"\n\n"
IHM_MSG_POPUP_5                             =	"Problème lors de la récupération du logo étiquette \"%s\"\n\n"
IHM_MSG_POPUP_6                             =	"Problème lors de la récupération du masque étiquette erreur \"%s\"\n\n"
IHM_MSG_POPUP_7                             =	"Erreur création IHM Slot"
IHM_MSG_POPUP_8                             =	"Erreur de Lancement du Thread Slot"
VAR_MSG_POPUP_2                             =	"Index num %d du tableau tabVariables est vide et nom recherché %s"
VAR_MSG_POPUP_3                             =	"Problème lors de la récupération de la propriété %s\n\n"
VAR_MSG_POPUP_4                             =	"Erreur à l'extraction des variables (%s)"
TRC_MSG_POPUP_1                             =	"Erreur inconnu lors de l'extraction des informations du produit\n"
MAI_TTR_POPUP                               =	"Erreur initialisation testeur"
MAI_MSG_POPUP_1                             =	"Allocation des ressources systèmes impossibles"
MAI_MSG_POPUP_2                             =	"Cette application est déjà ouverte"
MAI_MSG_POPUP_3                             =	"Erreur de connexion BDD: %s\n"
MAI_MSG_POPUP_4                             =	"Erreur récupération infos poste: %s\n"
MAI_MSG_POPUP_6                             =	"%sFichier de config %s non trouvé\n\n"
MAI_MSG_POPUP_7                             =	"Nom du serveur \"%s\" non trouvé dans section [%s] du fichier %s\n\n"
MAI_MSG_POPUP_8                             =	"Tag \"%s\" non trouvée dans section [%s] du fichier %s\n\n"
MAI_MSG_POPUP_9                             =	"%sNom du Pc non récupérable dans système\n\n"
MAI_MSG_POPUP_10                            =	"Le nom de la machine : %s n'a pas été trouvé dans le Tag \"%s\" de la section %s du paramétrage d'application en base de données pour le poste %s\n\n"
MAI_MSG_POPUP_11                            =	"Nom du serveur \"%s\" dans fichier_INI.ini inconnu"
MAI_MSG_POPUP_12                            =	"Tag \"%s\" non trouvée dans section %s du paramétrage d'application en base pour le poste %s\n\n"
MAI_MSG_POPUP_COPY_FONT                     =	"Erreur Copie de la Font Sagem dans Windows"
CAL_TTR_POPUP                               =	"Erreur dans la fonction %s"
FCT_TTR_POPUP_EMAIL_VAL                     =	"Erreur envoi e-mail de validation\nErreur: %i"
FCT_TTR_POPUP_EMAIL_ACT                     =	"Erreur envoi e-mail activation mode proto\nErreur: %i"
FCT_MSG_ERR_VERSION_BPO_TOPPROD             =	"La version de BTF actuelle : %s n'est pas autorisée. Voir liste des version ayant fait l'objet d'une validation TopProd : "%s""
IHM_TTR_LIB_SLOT                            =	"Libération Slot N°%d"
IHM_TTR_ESS_IMP                             =	"Essai Imprimante Slot N°%d"
IHM_MSG_LIB_SLOT                            =	"Etes-vous sûr de vouloir libérer le slot N°%d?"
IHM_MSG_ESS_IMP                             =	"Etes-vous sûr de vouloir faire un essai imprimante slot N°%d?"
IHM_BTN_OUI                                 =	"OUI"
IHM_BTN_NON                                 =	"NON"
THR_TTR_EMAIL                               =	"e-mail de Validation"
THR_MSG_EMAIL                               =	"Etes vous sur de vouloir envoyer un e-mail de Validation?"
THR_LIBELLE_ERREUR_PATINS_VIS               =	"Erreur Vis ou Patins"
THR_LIBELLE_ERREUR_COULEUR                  =	"Erreur Capteur Couleur"
THR_LIBELLE_ERREUR_LAME_MASSE               =	"Erreur Lame de masse"
THR_LIBELLE_ERREUR_DEMARRAGE                =	"Démarrage décodeur KO\n"
THR_LIBELLE_ERREUR_AUTORISATION             =	"Autorisation de passage KO\n"
THR_LIBELLE_ERREUR_LECTURE_NUID             =	"Pb lecture UniqueId"
THR_LIBELLE_ERREUR_PRISE_SN_CLIENT          =	"Erreur prise SN Client"
THR_LIBELLE_ERREUR_ECRITURE_FLASH           =	"Erreur Ecriture dans la flash"
THR_LIBELLE_ERREUR_TT_CLIENT                =	"Erreur TT Client"
THR_LIBELLE_ERREUR_TRACA_PARA               =	"Erreur tracabilité parallèle"
THR_LIBELLE_ERREUR_TRACA                    =	"Erreur tracabilité"
THR_LIBELLE_ERREUR_IMPRESSION               =	"Erreur Impression"
THR_LIBELLE_ERREUR_LOGO                     =	"Erreur Chargement logo"
THR_LIBELLE_ERREUR_LIBERATION_SLOT          =	"Libération du slot forcée"
THR_LIBELLE_ERREUR_FERMETURE_APPLI          =	"Fermeture Application"
THR_LIBELLE_ERREUR_LED                      =	"Erreur test LED"
THR_LIBELLE_ERREUR_SMC_PRESENCE             =	"Erreur SMC présence"
THR_LIBELLE_ERREUR_USB                      =	"Erreur USB"
THR_LIBELLE_ERREUR_ESATA                    =	"Erreur eSata"
THR_LIBELLE_ERREUR_SD_CARD                  =	"Erreur SD Card"
THR_LIBELLE_ERREUR_IR                       =	"Erreur InfraRouge"
THR_LIBELLE_ERREUR_RF                       =	"Erreur RF"
THR_LIBELLE_ERREUR_FLASH_NOR                =	"Erreur test FLASH NOR"
THR_LIBELLE_ERREUR_FLASH_NAND               =	"Erreur test FLASH NAND"
THR_LIBELLE_ERREUR_ECRAN                    =	"Erreur Test Ecran"
THR_LIBELLE_ERREUR_VISION_7_SEG             =	"Erreur Test Vision 7 Segments"
THR_LIBELLE_ERREUR_HDD                      =	"Erreur HDD"
THR_LIBELLE_ERREUR_BOUTON                   =	"Erreur Test bouton"
THR_LIBELLE_ERREUR_SMC_ABSENCE              =	"Erreur SMC absente"
THR_LIBELLE_ERREUR_EXTRACTION_HDD           =	"Erreur test Extraction HDD"
THR_LIBELLE_ERREUR_CONSO_VENTILO            =	"Erreur Conso/Ventilo"
THR_LIBELLE_ERREUR_VENTI_TACHY              =	"Erreur Ventilateur Tachymétrique"
THR_LIBELLE_ERREUR_VENTILO                  =	"Erreur Ventilateur"
THR_LIBELLE_ERREUR_DOCSIS                   =	"Erreur Lecture Adresse Mac Docsis"
THR_LIBELLE_ERREUR_NIM                      =	"Erreur Nim"
THR_LIBELLE_ERREUR_VIDEO                    =	"Erreur Video"
THR_LIBELLE_ERREUR_HDMI                     =	"Erreur Bluray Hdmi"
THR_LIBELLE_ERREUR_CHECK_APLLI_TT           =	"Erreur Check Appli et TT"
THR_LIBELLE_ERREUR_TEST_GET_STB_INFO        =	"Erreur Recup Info Decodeur"
THR_LIBELLE_ERREUR_TEST_CHIPSET_TEMPERATURE =	"Erreur Température Chipset"
THR_LIBELLE_ERREUR_LECTURE_CLE              =	"Erreur Lecture Cle"
FCT_LIBELLE_ERREUR_SN                       =	"Erreur generation SN"
FCT_LIBELLE_ERREUR_SN_NC                    =	"Erreur generation SN Numericables"
FCT_LIBELLE_ERREUR_SN_BYT                   =	"Erreur generation SN Bouygues"
FCT_LIBELLE_ERREUR_SN_CHIL                  =	"Erreur generation SN Chili"
FCT_LIBELLE_ERREUR_CODE_MATERIEL            =	"Erreur generation Code Matériel"
FCT_LIBELLE_ERREUR_SN_VODA                  =	"Erreur generation SN Vodafone"
FCT_LIBELLE_ERREUR_SN_CYFRA                 =	"Erreur generation SN Cyfra+"
FCT_LIBELLE_ERREUR_SN_DSI87SFR              =	"Erreur generation SN DSI87 HD SFR"
FCT_LIBELLE_ERREUR_SN_M45                   =	"Erreur generation SN M45"
FCT_LIBELLE_ERREUR_SN_IAD84HA               =	"Erreur generation SN IAD84 Hansenet"
FCT_LIBELLE_ERREUR_SN_DIGITURK              =	"Erreur generation SN Digiturk"
FCT_LIBELLE_ERREUR_SN_DCI85KDG              =	"Erreur generation SN DCI85KDG"
FCT_LIBELLE_ERREUR_SN_CLIENT                =	"Erreur generation numéro de série client \'%s\'"
FCT_LIBELLE_ERREUR_VERIF_LOCK_FLASH         =	"Erreur Verification si flash lockee"
FCT_LIBELLE_ERREUR_CRYPT_HDD                =	"Erreur Cryptage des donnees du disque dur"
FCT_LIBELLE_ERREUR_WRT_SN                   =	"Erreur Ecriture SN Sagem"
FCT_LIBELLE_ERREUR_WRT_CERTIFICAT_SSL       =	"Erreur Ecriture du Serial number du certificat ssl"
FCT_LIBELLE_ERREUR_WRT_SN_NC                =	"Erreur Ecriture SN Numericables"
FCT_LIBELLE_ERREUR_WRT_SN_BYT               =	"Erreur Ecriture SN Bouygues"
FCT_LIBELLE_ERREUR_WRT_SN_VODA              =	"Erreur Ecriture SN Vodafone"
FCT_LIBELLE_ERREUR_WRT_SN_DSI87_SFR         =	"Erreur Ecriture SN DSI87 SFR"
FCT_LIBELLE_ERREUR_WRT_SN_DIGITURK          =	"Erreur Ecriture SN Digiturk"
FCT_LIBELLE_ERREUR_WRT_SN_CLIENT            =	"Erreur Ecriture SN %s"
FCT_LIBELLE_ERREUR_ECRITURE_BADBLOCKS       =	"Erreur Ecriture du nombre de Bad Blocks"
FCT_LIBELLE_ERREUR_DESACTIV_ETHERNET        =	"Erreur Desactivation Ethernet"
FCT_LIBELLE_ERREUR_WRT_CLES                 =	"Erreur Ecriture des cles"
FCT_LIBELLE_ERREUR_WRT_RECUP_NAGRA          =	"Erreur Recuperation des infos Nagra"
FCT_LIBELLE_ERREUR_WRT_DOCSIS               =	"Erreur Ecriture SetMac Docsis"
FCT_LIBELLE_ERREUR_WOL                      =	"Erreur Test Wake On Lan"
FCT_LIBELLE_ERREUR_UNICITE                  =	"Erreur Filtre sur les violations d unicite"
FCT_LIBELLE_ERREUR_WRTTRACKING              =	"Erreur Ecriture WriteTracking"
FCT_LIBELLE_ERREUR_WRT_FLASH                =	"Erreur Ecriture dans la flash"
FCT_LIBELLE_ERREUR_CONFIGURATION            =	"Erreur de configuration en base"
FCT_LIBELLE_ERREUR_PARAMETRAGE              =	"Erreur de configuration du paramétrage de l'application en base de données"
FCT_LIBELLE_ERREUR_CNX_TELNET_SWITCH        =   "Connexion telnet Switch SP8T KO %s !!!"            
FCT_LIBELLE_ERREUR_PASSWORD_SWITCH          =   "Erreur Password Switch SP8T !!!"
FCT_LIBELLE_ERREUR_VERSION_TT               =   "Erreur Version TT"
FCT_LIBELLE_ERREUR_LECTURE_SN               =   "Erreur Lecture SN"
FCT_LIBELLE_ERREUR_SFC_PARENT               =   "Aucun SFC Parent trouvé pour ce SnCIE : %s"
FCT_LIBELLE_ERREUR_SFC_TROUVE               =   "SFC Found for this SnCIE: %s"
FCT_LIBELLE_ERREUR_RECUPERATION_SFC_PARENT  =   "Erreur à la récupération du SFC parent pour le SFC/Composant: %s."

WRT_LIBELLE_ERREUR_WRT_HARDWARE_ID          =	"Erreur Ecriture Hardware Id"
WRT_LIBELLE_ERREUR_WRT_MANU_ID              =	"Erreur Ecriture Manufacturer Id"
WRT_LIBELLE_ERREUR_WRT_HARD_VERSION         =	"Erreur Ecriture Hardware Version"
WRT_LIBELLE_ERREUR_WRT_DWL_ID               =	"Erreur Ecriture Download ID"
WRT_LIBELLE_ERREUR_WRT_IP                   =	"Erreur Ecriture IP serveur telechargement"
WRT_LIBELLE_ERREUR_WRT_PATH                 =	"Erreur Ecriture du chemin telechargement"
WRT_LIBELLE_ERREUR_WRT_CRYPT_FLUX           =	"Erreur Cryptage du flux"
WRT_LIBELLE_ERREUR_WRT_CMD_FIN              =	"Erreur Commande de finalisation du decodeur"
WRT_LIBELLE_ERREUR_WRT_PRERECETTE           =	"Erreur Activation du demarrage customise en pre-recette"
WRT_LIBELLE_ERREUR_WRT_SWITCH_TT_PANA       =	"Erreur Switch sur le TT Panasonic"
WRT_LIBELLE_ERREUR_WRT_CHECK_APPLI_PANA     =	"Erreur Switch sur la vérification de l'appli Panasonic"
WRT_LIBELLE_ERREUR_WRT_SWITCH_TO            =	"Erreur Forcage du passage du TT vers appli"
WRT_LIBELLE_ERREUR_WRT_FORC_TEL             =	"Erreur Forcage du telechargement"
WRT_LIBELLE_ERREUR_WRT_EFFACEMENT_TT        =	"Erreur Effacement zone TT"
WRT_LIBELLE_ERREUR_WRT_LOCK_FLASH           =	"Erreur Lockage de la Flash"
WRT_LIBELLE_ERREUR_WRT_REVERIF_LOCK_FLASH   =	"Erreur verification du lockage flash"
WRT_LIBELLE_ERREUR_WRT_RECUP_PWD_JTAG       =	"Erreur Recuperation mot de passe lockage Jtag"
WRT_LIBELLE_ERREUR_WRT_LOCK_JTAG            =	"Erreur Lockage du Jtag"
WRT_LIBELLE_ERREUR_WRT_CHIP_PAIRING         =	"Erreur Chipset pairing"
WRT_LIBELLE_ERREUR_WRT_CRYPTOCORE           =	"Erreur Activation cryptocore"
WRT_LIBELLE_ERREUR_WRT_FUSE_STATUS          =	"Erreur Get Fuse Status"
WRT_LIBELLE_ERREUR_WRT_DRM_FUSE             =	"Erreur Fusible DRM"
WRT_LIBELLE_ERREUR_WRT_MES_FUSE             =	"Erreur Activation du MES"
HDD_LIBELLE_ERREUR                          =	"Erreur lors du test du disque dur"
HDD_LIBELLE_ERREUR_SN_HDD                   =	"Le numserie du Hdd n a pas été lu"
HDD_LIBELLE_ERREUR_LEC_MODEL_HDD            =	"Le model du Hdd n a été pas lu"
HDD_LIBELLE_ERREUR_MODEL_HDD                =	"Le modele du HDD defini en base est different du HDD monte"
HDD_LIBELLE_ERREUR_SIZE_HDD                 =	"La taille du HDD definie en base est differente du HDD monte"
HDD_LIBELLE_ERREUR_FIRMWARE_HDD             =	"Le firmware du HDD defini en base est different du HDD monte"
HDD_LIBELLE_ERREUR_RETRAIT1_HDD             =	"Erreur durant le 1er test de retrait du disque dur"
HDD_LIBELLE_ERREUR_RETRAIT2_HDD             =	"Erreur durant le 2eme test de retrait du disque dur"
HDD_LIBELLE_ERREUR_SUP_DOUBLON              =	"Supression Doublons HddPwd KO"
HDD_LIBELLE_ERREUR_HDD_EMBALLE              =	"Le HDD est déja emballé"
HDD_LIBELLE_ERREUR_VERIF_HDD_EMBALLE        =	"Erreur vérification Hdd non emballé"
HDD_LIBELLE_ERREUR_HDD_LOCK                 =	"Ce Hdd est locké!"
HDD_LIBELLE_ERREUR_HDD_NON_LOCK             =	"Ce Hdd n est pas locké!"
HDD_LIBELLE_ERREUR_PASSAGE_BHD              =	"Le HDD n est pas passé au banc disque dur"
HDD_LIBELLE_ERREUR_PASSAGE_KO_BHD           =	"Le HDD est passé KO au banc disque dur"
HDD_LIBELLE_ERREUR_PARENTS_HDD              =	"Le HDD à plusieurs SnSfin parents"
HDD_LIBELLE_ERREUR_VERIF_PASSAGE_BHD        =	"Erreur verification passage au Banc Disque Dur"
HDD_LIBELLE_ERREUR_NOMENCLATURE_HDD         =	"Il n y à pas de Hdd dans la nomenclature"
HDD_LIBELLE_ERREUR_CREATION_CIE_HDD         =	"Erreur création Cie Hdd"
HDD_LIBELLE_ERREUR_FORMATAGE_SSD            =	"Erreur vérification formatage carte SSD"
HDD_LIBELLE_ERREUR_NON_LIEN_HDD             =	"Erreur vérification Hdd non lié"
HDD_LIBELLE_ERREUR_PWD_UNIQUE               =	"Un mot de passe de lockage UNIQUE est déja associé à ce Sn Hdd"
HDD_LIBELLE_ERREUR_TEST_PARTITIONS          =	"Erreur sur le test de vérification des partitions"
HDD_LIBELLE_ERREUR_RECUP_PARTITIONS         =	"Erreur lors de la récupération des informations de la partition : %s"
CLE_LIBELLE_ERREUR_LECTURE                  =	"Lecture cle %s impossible"
CLE_LIBELLE_ERREUR_ECRITURE                 =	"Erreur Ecriture cle %s"
LIE_LIBELLE_ERREUR_LIEN                     =	"%s déja lié"
CLE_MSG_FIL2LO                              =	"Echec de la verification de la video avec le vecteur de test"
FCT_MSG_FIL2LO                              =	"!! CARTE DE REFERENCE !!"
THR_MSG_FIL2LO                              =	"!! MODE PROTO ACTIVE !!"
FIL2LO_STR_WARNING_LOCK_NDS                 =	"!! WARNING => LOCK FLASH NDS DESACTIVE LA COMMANDE FLA_LOCK 0 !!"
FIL2LO_STR_CONF_STB                         =	"######## CONFIGURATION STB #######################"
FIL2LO_STR_TRACE_STB                        =	"######## TRACE STB ###############################"
FIL2LO_STR_RES_OK                           =	"############ PASSAGE OK ############\n"
FIL2LO_STR_RES_KO                           =	"############ PASSAGE KO ############"
FIL2LO_STR_DEBUT_TEST                       =	"DEBUT DE TEST"
FIL2LO_STR_FIN_TEST                         =	"FIN DE TEST"
FIL2LO_STR_ERREUR                           =	"ERREUR : %s\n"
FIL2LO_STR_DUREE_TEST                       =	"DUREE DU TEST : %d ms\n"
FIL2LO_STR_SOFT_VERSION                     =	"SOFT VERSION : %s\n"
FIL2LO_STR_SN_CIE                           =	"SN du CIE         : %s\n"
FIL2LO_STR_CODE_PRODUIT                     =	"               Code produit      : %s\n"
FIL2LO_STR_INDICE                           =	"               Indice            : %s\n"
FIL2LO_STR_SFIN_INDICE                      =	"               SFIN indice       : %s\n"
FIL2LO_STR_LOADER                           =	"               Loader            : %s\n"
FIL2LO_STR_APPLISOFT                        =	"               AppliSoft         : %s\n"
FIL2LO_STR_TT                               =	"               TT                : %s\n"
FIL2LO_STR_NOMENCLATURE_HW                  =	"               Nomenclature Hw   : %s\n"
FIL2LO_STR_NOMENCLATURE_BOOT                =	"               Nomenclature Boot : %s\n"
DIO_MSG_FIL2LO                              =	"Erreur LedsOff\n"
THR_MSG_CONTEXT_LED_PSOC                    =	"Test Led en cours"
THR_MSG_CONTEXT_SMARTCARD                   =	"Test SmartCard en cours"
THR_MSG_CONTEXT_USB                         =	"Test USB en cours"
THR_MSG_CONTEXT_ESATA                       =	"Test eSata en cours"
THR_MSG_CONTEXT_SDCARD                      =	"Test SD Card en cours"
THR_MSG_CONTEXT_IR                          =	"Test Infrarouge en cours"
THR_MSG_CONTEXT_RF                          =	"Test RF en cours"
THR_MSG_CONTEXT_FLASHNOR                    =	"Test FLASH NOR en cours"
THR_MSG_CONTEXT_FLASHNAND                   =	"Test FLASH NAND en cours"
THR_MSG_CONTEXT_ECRAN                       =	"Test Ecran en cours"
THR_MSG_CONTEXT_HDD                         =	"Test Disque Dur en cours"
THR_MSG_CONTEXT_BOUTONS                     =	"Test Boutons en cours"
THR_MSG_CONTEXT_CONSO                       =	"Test Consommation en cours"
THR_MSG_CONTEXT_VENTI_TACHY                 =	"Test Ventilateur Tachymétrique en cours"
THR_MSG_CONTEXT_VENTILO                     =	"Test Ventilateur en cours"
THR_MSG_CONTEXT_DOCSIS                      =	"Test MAC Docsis en cours"
THR_MSG_CONTEXT_NIM                         =	"Test NIM en cours"
THR_MSG_CONTEXT_VIDEO                       =	"Test Video en cours"
THR_MSG_CONTEXT_HDMI                        =	"Test Hdmi en cours"
THR_MSG_CONTEXT_CHECK_APPLI_TT              =	"Test Check Appli et TT en cours"
THR_MSG_CONTEXT_TEST_GET_STB_INFO           =	"Test Recuperation infos decodeur"
THR_MSG_CONTEXT_TEST_CHIPSET_TEMPERATURE    =	"Test Température Chipset en cours"
CLE_MSG_CONTEXT_LECTURE_CLE                 =	"Lecture cle %s"
MAI_TTR_EMAIL_FERMETURE1                    =	"Fermeture %s %s"
MAI_TTR_EMAIL_FERMETURE2                    =	"Fermeture %s %s %s-%s %s - %s(CIE)"
CLE_TTR_EMAIL_CHECK_NUMBER                  =	"Nagra Check Number"
CLE_MSG_EMAIL_CHECK_NUMBER                  =	"Check Number avant écriture PK: %s est différent Check Number après ecriture PK: %s"
CLE_TXT_DATE                                =	"Date: "
CLE_TXT_HEURE                               =	"Heure: "
CLE_TXT_CODE_PRODUIT                        =	"Code Produit: "
CLE_TXT_INDICE                              =	"Indice: "
CLE_TXT_SN                                  =	"Numéro de Série: "
ZEB_MSG_LOG_CAS_ID                          =	"Cas ID en forme : %s"
ZEB_MSG_LOG_DATE                            =	"Date : %s"
LIE_MSG_ACC_DEJA_LIE_AUTRE_DEC              =	"Accessoire déja lié à ce décodeur: %s"
LIE_MSG_ACC_DEJA_LIE                        =	"Accessoire déja lié au décodeur en cours: %s"
LIE_MSG_SUP_LIEN                            =	"Supression du lien entre le Sn Cie accessoire: %s et le Sn Sfin Stb"
LIE_MSG_DEC_DEJA_LIE                        =	"Décodeur déja lié a l\'accessoire en cours: %s"
MES_MSG_MES_NON_RECONNU                     =	"Mesure \"%s\" : Info avec mesure non reconnu (%s)"
MES_MSG_MES_ENREGISTREMENT                  =	"[Enregitrement mesure %s] %s"
THR_MSG_ERR_DETECTION_VIS                   =	"Erreur Détection vis : le vis %d n'est pas présent"
THR_MSG_ERR_DETECTION_PATINS                =	"Erreur Détection patin : le patin %d n'est pas présent"
THR_MSG_ERR_DETECTION_COULEUR                =	"Erreur Détection capteur couleur : le capteur %d n'est pas présent"
THR_MSG_DEMMARAGE                           =	"Démarrage décodeur OK\n"
THR_MSG_AUTORISATION_PASSAGE                =	"Autorisation de passage OK\n"
THR_MSG_ERR_THREAD_LOGO                     =	"Erreur de Lancement du Thread ChargerLogoZebra"
THR_MSG_ERR_THREAD_TESTFONC                 =	"Erreur de Lancement du Thread TestFonc"
THR_MSG_ERR_THREAD_LECTUREBDD               =	"Erreur de Lancement du Thread LectureBdd"
THR_MSG_ERR_THREAD_SECURE                   =	"Erreur de Lancement du Thread Sécurisation"
THR_MSG_ERR_THREAD_TRACA_PARA               =	"Erreur de Lancement du Thread Traçabilité Parallèle"
THR_MSG_ECRITURE_FLASH                      =	"Ecriture des infos dans la flash OK\n"
THR_MSG_SECURISATION_TRACA                  =	"Sécurisation et Traçabilité Parallèle OK\n"
THR_MSG_TEST_TT_CLIENT                      =	"TT Client OK\n"
THR_MSG_TRACA                               =	"Traçabilité OK\n"
THR_MSG_LIBERATION_SLOT                     =	"Libération du slot"
THR_MSG_ERR                                 =	"ERREUR: %s"
THR_MSG_RETRAIT_STB                         =	"RETRAIT DU DECODEUR (CHRONO = %ld)\n"
THR_MSG_ERR_DEVEROUILLAGE                   =	"Problème de déverrouillage bandeau"
THR_MSG_FIN_THREAD_LOGO                     =	"Fin du thread Logo Zebra"
THR_MSG_FIN_THREAD_TESTFONC                 =	"Fin du thread TestFonctionnel"
THR_MSG_FIN_THREAD_LECTUREBDD               =	"Fin du thread Lecture Cles"
THR_MSG_FIN_THREAD_SECURISATION             =	"Fin du thread Sécurisation"
THR_MSG_FIN_THREAD_TRACA_PARA               =	"Fin du thread Traçabilité Parallèle"
THR_MSG_ERR_NVM                             =	"Erreur NVM : l'en-tête de la clé est non conforme\n NvmHeader = [0x%02x,0x%02x,0x%02x,0x%02x]"
THR_MSGL_DUREE_LOGO                         =	"Temps de chargement du logo: %dms\n"
WOL_MSG_SLEEP                               =	"Sleep %i ms"
WOL_MSG_ERR_ENVOIE                          =	"Erreur de l'envoie de la trame WOL"
WOL_MSG_TIMEOUT                             =	"TimeOut %i s"
WOL_MSG_ERR_WOL1                            =	"Erreur Wake On Lan: %s"
WOL_MSG_ERR_WOL2                            =	"Erreur Wake On Lan"
WOL_MSG_WOL_OK                              =	"Wake On Lan: OK"
VAR_MSG_ERR_VAR_INCONNU                     =	"Type de variable inconnu (%d)"
VAR_MSG_ERR_VAR_ENREGISTREMENT1             =	"Enregistrement variables etat [%s] : %s"
VAR_MSG_ERR_VAR_ENREGISTREMENT2             =	"Enregistrement variables etat [%s]"
VAR_MSG_ERR_PROP_SUP                        =	"Suppression Propriete: %s"
VAR_MSG_ERR_VAR_UNIQUE_SUP1                 =	"Suppression variables etat unique[%s] : %s"
VAR_MSG_ERR_VAR_UNIQUE_SUP2                 =	"Suppression variables etat unique [%s]"
IHM_MSG_APPUYER_BTN                         =	"Appuyez sur tous les boutons en face avant..."
TRC_MSG_ERR_INCONNU                         =	"Erreur inconnu lors de l'extraction des informations du poste\n"
TRC_MSG_ERR_SN_NON_GENERE                   =	"SN non généré"
TRC_MSG_ERR_CODE_PASSAGE                    =	"Code Passage = %d \"%s\""
TRC_MSG_CODE_PASSAGE                        =	"Code Passage = %d"
TRC_MSG_ERR_CODE_DOUBLON                    =	"Code doublon = %d \"%s\""
TRC_MSG_CODE_DOUBLON                        =	"Code doublon = %d"
TRC_MSG_SUP_DOUBLON                         =	"Supression Doublons %s: %s sur le CIE: %s"
TRC_MSG_ERR_ALLOCATION_MEMOIRE              =	"Problème d'allocation mémoire"
TRC_MSG_ERR_ECRITURE_CLE                    =	"Erreur ecriture clé en BDD"
CLE_MSG_VALEUR1                             =	"Extraction valeur cle <%s> : la cle n'existe pas"
CLE_MSG_VALEUR2                             =	"Extraction valeur cle <%s> : impossible"
CLE_MSG_NETTOYAGE1                          =	"Nettoyage de la cle %s [Table:%s] [ID:%d]"
CLE_MSG_NETTOYAGE2                          =	"Nettoyage cle <%s> : la cle n'existe pas"
CLE_MSG_NETTOYAGE3                          =	"Nettoyage cle <%s> KO : %s"
CLE_MSG_NETTOYAGE4                          =	"Nettoyage cle <%s> KO"
CLE_MSG_LECTURE1                            =	"Fin lecture cle %s : OK (ID = %d)"
CLE_MSG_LECTURE2                            =	"Fin lecture cle %s : KO \"%s\""
CLE_MSG_LECTURE3                            =	"Plus de cle disponible"
CLE_MSG_ECRITURE1                           =	"Ecriture cle %s"
CLE_MSG_ECRITURE2                           =	"Fin écriture %s : OK"
CLE_MSG_ECRITURE3                           =	"Fin écriture %s : KO: %s"
CLE_MSG_LIBERATION1                         =	"Libération de la cle %s [Table:%s - ID:%d]"
CLE_MSG_LIBERATION2                         =	"Liberation Cle %s impossible \"%s\""
CLE_MSG_LIBERATION3                         =	"Liberation Cle %s impossible"
CLE_MSG_INFO_NAGRA1                         =	"Début: Récupération des infos NAGRALOG"
CLE_MSG_INFO_NAGRA2                         =	"Fin: Récupération des infos NAGRALOG"
CLE_MSG_INFO_NAGRA3                         =	"Erreur Envoie e-mail"
CLE_MSG_INFO_NAGRA4                         =	"Récupération Info Nagra"
CLE_MSG_INDICE_CLES1                        =	"Pas de clé configurée corresponant à ce nom de table"
CLE_MSG_INDICE_CLES2                        =	"Recherche de l'indice d'une clé : KO: %s"
CLE_MSG_LECTURE_STBPWD                      =	"Clé \"stbpasswords\" générée par le TT"
CLE_MSG_MISE_EN_FORME_HDCP                  =	"Erreur vérification du CRC (Calcul du SHA)"
CLE_MSG_ECRITURE_NDS_DCI85KDG               =	"Enregistrement Sn Client Dci 85 Kdg"
CLE_MSG_ERREUR_VERIF_SMI1                   =	"Le Chipset ID STB (=%s) est différent du Chipset PID de la BDD(=%s)"
CLE_MSG_ERREUR_VERIF_SMI2                   =	"Le Chipset ID STB (=%s) est différent du Chipset ID STB enregisté au BAV (=%s)"
CLE_MSG_ERREUR_NUM_CENTRE                   =	"Ce numéro de centre n'est pas supporté"
HDD_MSG_MODELE                              =	"Modele du HDD : %s"
HDD_MSG_SN                                  =	"SN complet du HDD : %s"
HDD_MSG_RESA_CLE_SN                         =	"Réservation ou récupération mot de passe sur Sn HDD : %s"
HDD_MSG_LOCKAGE                             =	"Lockage du HDD : %s"
HDD_MSG_TAILLE                              =	"Taille du HDD : %d Go"
HDD_MSG_FIRMWARE                            =	"Firmware du HDD : %s"
HDD_MSG_PAIRING_OK                          =	"Pairing Hdd OK"
HDD_MSG_ERR_PAIRING_KO                      =	"Pairing Hdd KO"
HDD_MSG_PAIRING_SANS_LOCK_OK                =	"Pairing Sans Lock Hdd OK"
HDD_MSG_ERR_PAIRING_SANS_LOCK_KO            =	"Pairing Sans Lock Hdd KO"
HDD_MSG_PAIRING_PLUS_LOCK_OK                =	"Pairing + Lock Hdd OK"
HDD_MSG_ERR_PAIRING_PLUS_LOCK_KO            =	"Pairing + Lock Hdd KO"
HDD_MSG_DEJA_LOCKE                          =	"Hdd déja locké\n"
HDD_MSG_DELOCKAGE_KO                        =	"Delockage KO\n"
HDD_MSG_RELOCKAGE_KO                        =	"Relockage KO\n"
HDD_MSG_GENERATION_PWD_LOCK                 =	"Génération du Pwd de Lockage\n"
HDD_MSG_PWD_DEJA_PRESENT                    =	"Pwd de Lockage déjà présent sur ce CIE\n"
HDD_MSG_ERR_GENERATION_CLES_PAIRING         =	"Erreur de generation des cles d'appairage"
HDD_MSG_DEJA_EMBALLE                        =	"Le HDD est déja emballé sur ce décodeur: %s"
HDD_MSG_LOCKE_OK                            =	"Disque dur Locke"
HDD_MSG_NBR_SFIN_HDD                        =	"Le HDD à %d Sn Sfin\n"
HDD_MSG_SN_SFIN_HDD                         =	"Sn Sfin: %s"
HDD_MSG_PASSAGE_KO_BHD                      =	"Le HDD %s est passé KO au banc disque dur le %s"
HDD_MSG_PASSAGE_OK_BHD                      =	"Le HDD %s est passé OK au banc disque dur le %s"
HDD_MSG_CREATION_SN_CIE_HDD                 =	"Création du Sn CIE Hdd: %s"
HDD_MSG_HDD_ABSENT_NOMENCLATURE             =	"Il n y à pas de Hdd dans la nomenclature"
HDD_MSG_SN_CIE_HDD_DEJA_PRESENT             =	"Le Sn CIE Hdd: %s existe déja"
HDD_MSG_CODE_PRODUIT_CIE_HDD                =	"Code produit Cie Hdd %s"
HDD_MSG_ERR_CODE_PRODUIT_HDD                =	"Le code produit Cie Hdd lu: %s est différent du code produit Hdd attendu: %s"
HDD_MSG_TEST_PARTITIONS                     =	"Test de vérification des Partitions :"
HDD_MSG_TEST_PARTITIONS_OK                  =	"Vérification des Partitions OK"
HDD_MSG_PRES_PARTITION                      =	"Partition : %s trouvée"
HDD_MSG_ABS_PARTITION                       =	"Partition : %s non trouvée"
HDD_MSG_BLOCS_PARTITION_OK                  =	"Nombre de blocs trouvé : %d supérieur ou égal au nombre de blocs définis en base : %d"
HDD_MSG_BLOCS_PARTITION_NOK                 =	"Erreur : nombre de blocs trouvé : %d inférieur au nombre de blocs définis en base : %d"
HDD_MSG_TYPE_PARTITION_OK                   =	"Type de partition trouvé : %s conforme au type défini en base : %s"
HDD_MSG_TYPE_PARTITION_NOK                  =	"Erreur : Type de partition trouvé : %s différent du type défini en base : %s"
TFC_MSG_PAT1_DETECTE                        =	"Patin 1 détecté"
TFC_MSG_PAT2_DETECTE                        =	"Patin 2 détecté"
TFC_MSG_PAT3_DETECTE                        =	"Patin 3 détecté"
TFC_MSG_PAT4_DETECTE                        =	"Patin 4 détecté"
TFC_MSG_PAT5_DETECTE                        =	"Patin 5 détecté"
TFC_MSG_VIS1_DETECTEE                       =	"Vis 1 détectée"
TFC_MSG_VIS2_DETECTEE                       =	"Vis 2 détectée"
TFC_MSG_VIS3_DETECTEE                       =	"Vis 3 détectée"
TFC_MSG_VIS4_DETECTEE                       =	"Vis 4 détectée"
TFC_MSG_COUL1_DETECTE                       =	"Capteur Couleur 1 détecté"
TFC_MSG_DEMSTB_ERR_COM                      =	"Erreur COM [%d]: %s\n"
TFC_MSG_DEMSTB_DEM_CHRONO                   =	"DEMARRAGE DU DECODEUR (CHRONO = %d)\n"
TFC_MSG_DEMSTB_ERR_PREALIMENTATION          =	"PAS DE PREALIMENTATION POSSIBLE AVEC CE TT"
TFC_MSG_DEMSTB_ERR_CMD_TT_INIT              =	"Erreur commande TT d'initialisation decodeur"
TFC_MSG_VTL_OFF                             =	"Ventilateur OFF ( 0%) KO"
TFC_MSG_CONSO_PW                            =	"Puissance consomée : %f\n"
TFC_MSG_VTL_ON                              =	"Ventilateur ON ( 100%) KO"
TFC_MSG_VTL_OK                              =	"Présence Ventilateur OK"
TFC_MSG_VTL_ERR_KO                          =	"Présence Ventilateur KO"
TFC_MSG_CONSO_VTL                           =	"Conso Ventilateur  :  %f\n\n OK"
TFC_MSG_VTL_ERR_CONSO                       =	"Conso Ventilateur  :  %f\n\n KO"
TFC_MSG_CONSO_ERR_LECTURE                   =	"Lecture conso impossible : %s"
TFC_MSG_BTN_ERR_ACTIVATION                  =	"Erreur lors de l'activation des boutons"
TFC_MSG_BTN_ERR_DESACTIVATION               =	"Erreur lors de la désactivation des boutons"
TFC_MSG_BTN_CONF_NB_APPUIS                  =	"Nombre d'appui attendus  : "
TFC_MSG_BTN_CONF_ORDRE                      =	"Appuyer dans l'ordre"
TFC_MSG_BTN_CONF_SIMULTANE                  =	"Détection Appui Simultané Activée"
TFC_MSG_BTN_OK                              =	"Bouton %d OK"
TFC_MSG_BTN_OUVERTURE_POP_UP                =	"Ouverture du Pop Up Bouton"
TFC_MSG_BTN_FERMETURE_POP_UP                =	"Fermeture du Pop Up Bouton"
TFC_MSG_BTN_ERR_KO                          =	"Fonctionnement boutons KO"
TFC_MSG_BTN_ERR_DATE                        =	"Erreur lors de la récupération du format de date"
TFC_MSG_BTN_ERR_TIMEOUT                     =	"Time Out Détecté.\n"
TFC_MSG_BTN_ERR_SIMULTANE                   =	"Appui Simultané Détecté.\n"
TFC_MSG_BTN_ERR_DESORDRE                    =	"Appui dans le Désordre Détecté.\n"
TFC_MSG_IR_RUWIDO                           =	"Passage en protocole RUWIDO KO"
TFC_MSG_IR_ERR_NEC                          =	"Le décodeur ne passe pas en mode NEC"
TFC_MSG_IR_ERR_IR                           =	"Le décodeur ne passe pas en mode Infra Rouge"
TFC_MSG_IR_TOUCHE_OK                        =	"Attente pression touche\ntélécommande paramétrée..."
TFC_MSG_IR_RF_TOUCHE_ROUGE                  =	"Attente pression touche rouge..."
TFC_MSG_IR_RF_TOUCHE_0                      =	"Attente pression touche 0..."
TFC_MSG_IR_CODE_RECU                        =	"Code télecommande reçu  :  %s"
TFC_MSG_IR_RF_CODE_RECU_SFR                 =	"Code télecommande reçu  :  0x%x"
TFC_MSG_IR_ERR                              =	"Erreur IR : %s"
TFC_MSG_IR_OUVERTURE_POP_UP                 =	"Ouverture du Pop Up Infrarouge"
TFC_MSG_IR_FERMETURE_POP_UP                 =	"Fermeture du Pop Up Infrarouge"
TFC_MSG_RF_ERR_PW                           =	"Puissance de l'emetteur RF doit etre comprise entre -18dBm à 10dBm"
TFC_MSG_RF_ERR_PASSAGE_PROTOCOLE_RF         =	"Passage en protocole RF KO"
TFC_MSG_RF_ERR_PASSAGE_RF                   =	"Le décodeur ne passe pas en mode RF"
TFC_MSG_RF_ERR_SYNCWORD                     =	"Le décodeur ne modifie sa valeur de SyncWord"
TFC_MSG_RF_ERR_MODULE                       =	"Le module RF ne répond pas"
TFC_MSG_RF_ERR                              =	"Erreur RF : %s"
TFC_MSG_USB_INSERTION                       =	"Insérez la clef Usb"
TFC_MSG_USB_DETECTION                       =	"USB détecté"
TFC_MSG_USB_ERR                             =	"USB non détecté"
TFC_MSG_SD_INSERTION                        =	"Insérez la Carte SD"
TFC_MSG_SD_DETECTION                        =	"Carte SD détectée"
TFC_MSG_SD_ERR_CMDTT                        =	"CmdTT non définie pour test SD Card"
TFC_MSG_SD_ERR                              =	"Card SD non détecté"
TFC_MSG_NAND_ID                             =	"Flash Nand ID : %s\n"
TFC_MSG_NAND_ERR_ID_NONCONFORME             =	"FLASH ID non conforme [%s] !"
TFC_MSG_NAND_ERR_ID                         =	"Identifiant de la Flash Nand non trouvé dans la réponse du TT !"
TFC_MSG_NAND_TAILLE                         =	"Flash Nand Taille : %s\n"
TFC_MSG_NAND_ERR_TAILLE_NONCONFORME         =	"Taille de la FLASH non conforme [%s] !"
TFC_MSG_NAND_ERR_TAILLE                     =	"Taille de la Flash Nand non trouvé dans la réponse du TT !"
TFC_MSG_NAND_ERR                            =	"Test de la FLASH NAND KO"
TFC_MSG_CARD_INSERTION                      =	"Insérez la SmartCard"
TFC_MSG_CARD_ERR_DETECTION                  =	"SmartCard non détectée"
TFC_MSG_CARD_DETECTION                      =	"SmartCard détectée"
TFC_MSG_CARD_RETIREZ                        =	"Retirez la SmartCard"
TFC_MSG_CARD_ERR_RETRAIT                    =	"Retrait SmartCard non détecté"
TFC_MSG_CARD_RETRAIT                        =	"Retrait SmartCard détectée"
TFC_MSG_DOCSIS_ERR_VERSION_NONLUE           =	"Versions Docsis non lues"
TFC_MSG_DOCSIS_ERR_VERSION_DIFF             =	"La version du vendor du Docsis (%s) est différente de celle du décodeur (%s)"
TFC_MSG_DOCSIS_ERR_VERSION_SOFT             =	"La version du soft du Docsis (%s) est différente de celle du décodeur (%s)"
TFC_MSG_DOCSIS_ERR_ADRESSE_NONLUE           =	"Adresse Modem Docsis non lue"
TFC_MSG_DOCSIS_ERR_ADRESSE                  =	"Adresse Modem Docsis non héxa 12 digits"
TFC_MSG_DOCSIS_ERR_ADRESSE_BDD		    =	"Composant Mac docsis lue %s différente du Composant Mac docsis en Bdd %s"
TFC_MSG_EMTA_ERR_ADRESSE_BDD		    =	"Mac EMTA calculée %s différente de Mac EMTA en Bdd %s"
TFC_MSG_SSID_ERR_LECTURE		    =	"Lecture SSID impossible - vérification non effectuée"
TFC_MSG_SSID_ERR_BDD			    =	"SSID lu %s différent du SSID en Bdd %s"
TFC_MSG_SSID_ERR_MASQUE			    =	"SSID récupéré dans le STB : %s ne commence pas par %s"
TFC_MSG_ECRAN_ERR                           =	"Fonctionnement Ecran KO"
TFC_MSG_VISION_FRONTS_ERR                   =	"Nombre de Fronts relevés incorrects (retour dll Vision : %d)"
TFC_MSG_NIM_ERR_SN                          =	"SFC CIU Parent du Sn NIM : %s est different du SFC CIU de la Stb: %s"
TFC_MSG_NIM_ERR_VAR_SN                      =	"Variable \"etat_DEC_GEN_sSnNIM\" non renseignée au BFE"
TFC_MSG_NIM_ERR_SN_INCONNU                  =	"Numserie Nim inconnu"
TFC_MSG_NIM_CIE                             =	"Cie Nim %s %s"
TFC_MSG_NIM_ERR                             =	"La Nim présente en nomenclature est différente de la Nim montée"
TFC_MSG_INFO_VERSION_APPLI                  =	"Version de l'appli : %s"
TFC_MSG_INFO_HARDWARE                       =	"Hardware Id : %s"
TFC_MSG_VIDEO_FLUX_ERR                      =	"Flux Absent"
TFC_MSG_VENTILO_CAPTEUR_OK                  =	"Capteur présent"
TFC_MSG_VENTILO_CAPTEUR_KO                  =	"Capteur absent, test ventilateur non effectué"
TFC_MSG_VENTILO_CAPTEUR_ERREUR              =	"Capteur en erreur, test ventilateur non effectué"
TFC_MSG_VENTILO_OK                          =	"Ventilateur présent et à l'endroit"
TFC_MSG_VENTILO_SENS_KO                     =	"Ventilateur à l'envers"
TFC_MSG_VENTILO_PRESENCE_KO                 =	"Ventilateur non branché"
TFC_MSG_GET_STB_INFO_VERSION_APPLI          =	"Version Appli configurée en base:%s, différente de la version remontée par le décodeur:%s"
TFC_MSG_GET_STB_INFO_VERSION_HARDWAREID     =	"Version HardwareId configurée en base:%s, différente de la version remontée par le décodeur:%s"
TFC_MSG_INITIALISATION_SWITCH_OK            =    "Initialisation Switch OK"
TFC_MSG_LECTURE_VERSION_OK                  =   "Lecture version TT OK"
TFC_MSG_LECTURE_SN_OK                       =   "Lecture SN OK"
TFC_MSG_VERIF_VERSION_FIRMWARE_OK           =   "Verification version Firmware OK"
TFC_MSG_VERIF_VERSION_FIRMWARE_KO           =   "Verification version Firmware KO"
TFC_MSG_INITIALISATION_OK        	    =   "Initialization OK"
TFC_MSG_DRIVER_2G_KO                        =   "Driver 2G KO"
TFC_MSG_DRIVER_5G_KO                        =   "Driver 5G KO"
TFC_MSG_TEST_BOUTON_OK        	            =   "Test Bouton OK"
TFC_MSG_Configuration_IR_OK    	            =   "configuration IR OK"
TFC_MSG_Configuration_IR_KO    	            =   "configuration IR KO"
TFC_MSG_TEST_IR_OK       	            =   "Test IR OK"
TFC_MSG_TEST_IR_KO       	            =   "Test IR KO"
TFC_MSG_TEST_LED_OK       	            =   "TEST LED OK"
TFC_MSG_Configuration_2G_OK   	            =   "Configuration Wifi  2.4 GHz OK"
TFC_MSG_Configuration_2G_KO                 =   "Erreur configuartion 2.4 GHz"
TFC_MSG_Mesures_2G_OK                       =   "Mesures Wifi 2.4 Ghz OK"
TFC_MSG_ERREUR_Nbre_NUM_SWITCH_2G           =   "Le nombre de valeurs dans la/les variable(s) de numeros des Switch est différent au nombre d'antenne 2G! Impossible d'obtenir les numeros des Switch"
TFC_MSG_ERREUR_SWITCH_PORT_SP8T             =   "probléme Switch port SP8T !!!"
TFC_MSG_ERREUR_ACTIVATION_2G                =   "Erreur Activation wifi 2G"
TFC_MSG_ERREUR_CONFIGURATION_POWERMETER     =   "Erreur Configuration powermetter"
TFC_MSG_ERREUR_CONFIGURATION_BDD            =   "Erreur Configuration BDD"     
TFC_MSG_ERREUR_MESURE_2G                    =   "Erreur Mesure 2G Antenne %d"
TFC_MSG_ERREUR_NBRE_ANTENNES_2G             =   "Pas de mesures antenne 2G (Nombre antenne egal 0 en TCM)"  
TFC_MSG_ERREUR_CONF_2G_NON_EXIST            =   "conf_DEC_BNFT_CMD_ACTIVE_ANNT_2G n'existe pas"
TFC_MSG_Configuration_5G_OK   	            =   "Configuration Wifi  5 GHz OK"
TFC_MSG_Configuration_5G_KO                 =   "Erreur configuartion 5 GHz"
TFC_MSG_Mesures_5G_OK                       =   "Mesures Wifi 5 GHz OK"
TFC_MSG_ERREUR_Nbre_NUM_SWITCH_5G           =   "Le nombre de valeurs dans la/les variable(s) de numeros des Switch est différent au nombre d'antenne 5G! Impossible d'obtenir les numeros des Switch"
TFC_MSG_ERREUR_ACTIVATION_5G                =   "Erreur Activation wifi 5G" 
TFC_MSG_ERREUR_MESURE_5G                    =   "Erreur Mesure 5G Antenne %d"
TFC_MSG_ERREUR_NBRE_ANTENNES_5G             =   "Pas de mesures antenne 5G (Nombre antenne egal 0 en TCM)"  
TFC_MSG_ERREUR_CONF_5G_NON_EXIST            =   "conf_DEC_BNFT_CMD_ACTIVE_ANNT_5G n'existe pas"
TFC_MSG_Configuration_BT_OK   	            =   "Configuration Wifi  BT OK"
TFC_MSG_Configuration_BT_KO                 =   "Erreur configuartion BT"
TFC_MSG_Mesures_BT_OK                       =   "Mesures Wifi BT OK"
TFC_MSG_ERREUR_Nbre_NUM_SWITCH_BT           =   "Le nombre de valeurs dans la/les variable(s) de numeros des Switch est différent au nombre d'antenne BT! Impossible d'obtenir les numeros des Switch"
TFC_MSG_ERREUR_ACTIVATION_BT                =   "Erreur Activation wifi BT" 
TFC_MSG_ERREUR_MESURE_BT                    =   "Erreur Mesure BT Antenne %d"
TFC_MSG_ERREUR_NBRE_ANTENNES_BT             =   "Pas de mesures antenne BT (Nombre antenne egal 0 en TCM)"  
TFC_MSG_ERREUR_CONF_BT_NON_EXIST            =   "conf_DEC_BNFT_CMD_ACTIVE_ANNT_BT n'existe pas"
TFC_MSG_FINALISATION_OK                     =   "Finalisation OK"
TFC_MSG_FINALISATION_KO                     =   "Finalisation KO"
TFC_MSG_ERREUR_CONF_Finalisation_NON_EXIST  =   "conf_DEC_BNFT_FINALISATION n'existe pas"
TFC_MSG_TRACABILITE_OK                      =   "Traçabilite OK"
TFC_MSG_TRACABILITE_KO                      =   "Traçabilite KO"
TFC_MSG_PERTE_PROMPT_OK                     =   "Perte Prompt OK"
TFC_MSG_PERTE_PROMPT_KO                     =   "Perte Prompt KO"   
TFC_MSG_ERREUR_BRANCHEMENT_POWERMETER       =   "Vérifier branchement powermetter USB %s !!"  
TFC_MSG_ERREUR_TYPE_POWERMETER              =   "Erreur configuration type powermetter: Type autorisé =  USB %s !!"
TFC_MSG_ATTENTE_PING                        =   "Attente Ping Switch"

FCT_MSG_CODE_PRODUIT_EXISTE_DIFFERENT       =	"Code Produit SFIN choisi: %s différent du Code Produit SFIN parent déja existant: %s"
FCT_MSG_GENE_SN_VIDE_NOGENE                 =	"SN vide, aucun SN n'a été généré!"
FCT_MSG_GENE_SN_UNDEF_BYT                   =	"Generation SN Bouygues impossible : variable \'%s\' non defini"
FCT_MSG_GENE_SN_UNDEF_CHILI                 =	"Generation SN Chili impossible : variable \'%s\' non defini"
FCT_MSG_GENE_CODEMATERIEL_UNDEF             =	"Generation Code Matériel impossible : variable \'%s\' non defini"
FCT_MSG_GENE_SN_UNDEF_VODA                  =	"Generation SN Vodafone impossible : variable \'%s\' non defini"
FCT_MSG_GENE_SN_UNDEF_CYFRA                 =	"Generation SN Cyfra+ impossible : variable \'%s\' non defini"
FCT_MSG_GENE_SN_UNDEF_DSI87                 =	"Generation SN DSI87 HD SFR impossible : variable \'%s\' non defini"
FCT_MSG_GENE_SN_UNDEF_M45                   =	"Generation SN M45 impossible : variable \'%s\' non defini"
FCT_MSG_GENE_SN_UNDEF_IAD84HA               =	"Generation SN IAD84 Hansenet impossible : variable \'%s\' non defini"
FCT_MSG_GENE_SN_UNDEF_DIGITURK              =	"Generation SN Digiturk impossible : variable \'%s\' non defini"
FCT_MSG_GENE_SN_CLIENT                      =	"Generation numéro de série client \'%s\' impossible : variable \'%s\' non defini"
FCT_MSG_TRACABDD_STRING                     =	"TracaBDD : %s\n"
FCT_MSG_PASS_KO_BDD_SNCIE                   =	"Enregistrement passage KO en Traçabilité SFC Pfin: %s\n"
FCT_MSG_NO_START                            =	"Pas d'enregistrement en Traça : Start sur SFC Pfin Non effectué"
FCT_MSG_TRACABDD_KO_STRING                  =	"Traçabilité KO : %s"
FCT_MSG_SN_TESTENCOURS                      =	"Ce SN CIE est en cours de test sur l'autre slot!"
FCT_MSG_MAUVAISE_VERSION_CIE                =	"La version du CIE en BDD (%s) est différente de celle du décodeur (%s)"
FCT_MSG_VERSION_CIE_PASENFLASH              =	"La version du CIE n'est pas inscrite en flash"
FCT_MSG_MAUVAIS_INDICE_CIE                  =	"L'indice du CIE en BDD (%s) est différent de celui du décodeur (%s)"
FCT_MSG_INDICE_CIE_PASENFLASH               =	"L'indice du CIE n'est pas inscrit en flash"
FCT_MSG_MAUVAIS_MASQUE_CIE                  =	"Les masques du SN CIE en BDD sont différents de celui du décodeur"
FCT_MSG_SERIAL_CIE_PASENFLASH               =	"Le serial number du CIE n'est pas inscrit en flash"
FCT_MSG_MAUVAIS_LOADER                      =	"La version du Loader (%s) en BD est différente de celle du décodeur (%s)"
FCT_MSG_MAUVAISE_NOMENCLATURE_HARD          =	"La Nomenclature Hard (%s) en BD est différente de celle du décodeur (%s)"
FCT_MSG_MAUVAISE_NOMENCLATURE_BOOT          =	"La Nomenclature Boot (%s) en BD est différente de celle du décodeur (%s)"
FCT_MSG_MAUVAISE_FULL_SALES_TYPE            =	"Le Full Sales Type (%s) en BD est différente de celle du décodeur (%s)"
FCT_MSG_SN_CIE_STRING                       =	"Sn Cie: %s"
FCT_MSG_TEST_AUTORISATION                   =	"Test de l'autorisation de passage : %s"
FCT_MSG_PASSAGE_NON_AUTORISE                =	"Passage non autorisé"
FCT_MSG_VERIF_FLASH_LOCKE                   =	"Verification si flash lockee"
FCT_MSG_CRYPTAGE_DONNEES_HDD                =	"Cryptage des données du disque dur"
FCT_MSG_CRYPTAGE_DONNEES_HDD_INHIBE         =	"Cryptage des données du disque dur inhibé : carte de REFERENCE"
FCT_MSG_ECRITURE_SN_SAGEM                   =	"Ecriture SN Sagem"
FCT_MSG_ECRITURE_SN_SSL                     =	"Ecriture du Serial number du certificat ssl"
FCT_MSG_PASDECRITURE_SNCLIENT               =	"Ecriture en Flash du Sn Client désactivée"
FCT_MSG_ECRITURE_SN_BYT                     =	"Ecriture SN Bouygues"
FCT_MSG_ECRITURE_SN_VODA                    =	"Ecriture SN Vodafone"
FCT_MSG_PASDECRITURE_SN_CYFRA               =	"Pas d'écriture SN Cyfra+"
FCT_MSG_PASDECRITURE_SN_CHILI               =	"Pas d'écriture SN Telefonica Chili"
FCT_MSG_ECRITURE_SN_DSI87                   =	"Ecriture SN Dsi87 Hd Sfr"
FCT_MSG_ECRITURE_SN_DIGITURK                =	"Ecriture SN Digiturk"
FCT_MSG_ECRITURE_SN_CLIENT                  =	"Ecriture SN %s"
FCT_MSG_ECRITURE_BADBLOCKS                  =	"Ecriture du nombre de Bad Blocks"
FCT_MSG_DESACTIVATION_ETHERNET              =	"Desactivation Ethernet"
FCT_MSG_ECRITURE_DES_CLES                   =	"Ecriture des cles"
FCT_MSG_ECRITURE_SETMAC_DOCSIS              =	"Ecriture SetMac Docsis"
FCT_MSG_TEST_WAKEONLAN                      =	"Test Wake On Lan"
FCT_MSG_MAJ_PROPRIETES_DEBUT                =	"Début: MAJ des propriétés"
FCT_MSG_MAJ_PROPRIETES_FIN                  =	"Fin: MAJ des propriétés"
FCT_MSG_FILTRE_UNICITE                      =	"Filtre sur les violations d'unicité"
FCT_MSG_ECRITURE_WRITETRACKING              =	"Ecriture WriteTracking"
FCT_MSG_SECURISATION                        =	"Sécurisation Produit"
FCT_MSG_TRACABILITE_MESURE                  =	"Enregistrement des Mesures en Traçabilité"
FCT_MSG_TRACABILITE_HDD                     =	"Enregistrement des infos HDD en Traçabilité"
FCT_MSG_TRACABILITE_COLLECT                 =	"Collecte des données STB en Traçabilité"
FCT_MSG_TRACABILITE_ASSEMBLE                =	"Assemblage des données STB en Traçabilité"
FCT_MSG_ECRITURE_WRITETRACKING_INHIBE       =	"Ecriture WriteTracking inhibé : carte de REFERENCE"
FCT_MSG_ECRITURE_FLASH_SKIPPE               =	"Ecriture de la FLASH skippé par option de compilation"
FCT_MSG_CIE_SN_NON_REMONTE                  =	"Le SN du CIE n'est pas remonté"
FCT_MSG_CIE_INDICE_NON_REMONTE              =	"L'indice du CIE n'est pas remonté"
FCT_MSG_CIE_CODE_PRODUIT_NON_REMONTE        =	"Le code produit du CIE n'est pas remonté"
FCT_MSG_LOADER_NON_REMONTE                  =	"Le loader n'est pas remonté"
FCT_MSG_TT_NON_REMONTE                      =	"Le TT n'est pas remonté"
FCT_MSG_NOMENCLATURE_HW_NON_REMONTE         =	"La nomenclature hardware n'est pas remontée"
FCT_MSG_NOMENCLATURE_BOOT_NON_REMONTE       =	"La nomenclature boot n'est pas remontée"
FCT_MSG_FULL_SALES_TYPE_NON_REMONTE         =	"La nomenclature Full Sales Type n'est pas remontée"
FCT_MSG_VARIABLE_STRING_NON_DEFINIE         =	"Variable \"%s\" non défini"
FCT_MSG_ERR_RECUP_VAR_TRACA                 =	"Erreur de récupération des variables de tracabilité"
FCT_MSG_ERR_CMDTT_TIMEOUT                   =	"Erreur commande TT (%s) : time out en réception"
FCT_MSG_ERR_CMDTT_FAIL                      =	"Erreur commande TT (%s) : fail trouvé"
FCT_MSG_ERR_CMDTT_NON_TROUVE_STRING         =	"Erreur commande TT (%s) : tag non trouvé (%s)"
FCT_MSG_ERR_CMDTT_STRING                    =	"Erreur commande TT (%s) : %s"
FCT_MSG_ERR_CMDTT_ECHO1                     =	"Erreur sur le contrôle de l'echo : dépassement de buffer"
FCT_MSG_ERR_CMDTT_ECHO2                     =	"Erreur sur le contrôle de l'echo (non trouvé) de la commande TT."
FCT_MSG_ERR_CMDTT_ECHO3                     =	"Erreur sur le contrôle de l'echo (non trouvé) de la commande TT : %s"
FCT_MSG_CMDTT_ECHO_NO_AFF                   =	"Commande non affichée."
FCT_MSG_CMDTT_ECHO_OK                       =	"Contrôle de l'echo OK sur la commande TT : %s"
FCT_MSG_CHECK_NUMBER_STRING                 =	"Check Number : %s"
FCT_MSG_ERREUR_DE_COM                       =	"Erreur de Com"
FCT_MSG_DIFF_CHIPSETID_MASQUE               =	"Chipset Id différent du masque"
FCT_MSG_ERR_LECT_UNIQUEID_STRING            =	"Erreur FCT_LectureUniqueId : %s"
FCT_MSG_ERR_LECT_FLASH_ID_STRING            =	"Erreur Lecture Flash Device ID : %s"
FCT_MSG_ERR_LECT_CHIP_IDENT_STRING          =	"Erreur Lecture Chipset ST IDENT : %s"
FCT_MSG_LIST_CIE_NOM                        =	"<CIE>  Nom                                : %s\n"
FCT_MSG_LIST_CIE_REF                        =	"<CIE>  Référence                          : %s\n"
FCT_MSG_LIST_CIE_IND                        =	"<CIE>  Indice                             : %s\n"
FCT_MSG_LIST_SFIN_NOM                       =	"<SFIN> Nom                                : %s\n"
FCT_MSG_LIST_SFIN_REF                       =	"<SFIN> Référence                          : %s\n"
FCT_MSG_LIST_SFIN_IND                       =	"<SFIN> Indice                             : %s\n"
FCT_MSG_LIST_PFIN_NOM                       =	"<PFIN> Nom                                : %s\n"
FCT_MSG_LIST_PFIN_REF                       =	"<PFIN> Référence                          : %s\n"
FCT_MSG_LIST_PFIN_IND                       =	"<PFIN> Indice                             : %s\n"
FCT_MSG_OUVRIR_FICHIER_IMPOSSIBLE           =	"Ouverture du fichier \'%s\' impossible"
FCT_MSG_CREER_FICHIER_IMPOSSIBLE            =	"Creation du fichier \'%s\' impossible"
FCT_MSG_RESULT_SFC_PFIN                     =	"SFC Pfin SAP ME                           : %s\n"
FCT_MSG_RESULT_SFC_CIU                      =	"SFC Ciu SAP ME                            : %s\n"
FCT_MSG_SAPME_REF_CMS                       =	"OF Gamme CMS du SFC Ciu                   : %s\n"
FCT_MSG_SAPME_TYPE_CMS                      =	"<SAPME> Type OF Gamme CMS                 : %s\n"
FCT_MSG_SAPME_REF_INTEG                     =	"OF Gamme Intégration du SFC Pfin          : %s\n"
FCT_MSG_SAPME_TYPE_INTEG                    =	"<SAPME> Type OF Gamme Intégration         : %s\n"
FCT_MSG_RESULT_SN_CIE                       =	"Sn CIE en flash STB                       : %s\n"
FCT_MSG_RESULT_VERSION_CIE                  =	"Version CIE en flash STB                  : %s\n"
FCT_MSG_RESULT_INDICE_CIE                   =	"Indice CIE en flash STB                   : %s\n"
FCT_MSG_RESULT_POSTE_TRACACOM               =	"Poste Tracacom                            : %s\n"
FCT_MSG_RESULT_OPR_POSTE_SAP_ME             =	"Opération Poste SAP ME                    : %s\n"
FCT_MSG_RESULT_RSC_POSTE_SAP_ME             =	"Ressource Poste SAP ME                    : %s\n"
FCT_MSG_RESULT_OPR_PRINT_SAP_ME             =	"Opération Impression SAP ME               : %s\n"
FCT_MSG_RESULT_RSC_PRINT_SAP_ME             =	"Ressource Impression SAP ME               : %s\n"
FCT_MSG_RESULT_CHIPSET_ID                   =	"Chipset ID (decimale)                     : %s\n"
FCT_MSG_RESULT_CODE_AUTORISATION            =	"Code Autorisation de passage              : %d\n"
FCT_MSG_RESULT_LIBELLE_ERREUR               =	"Libelle erreur                            : %s\n"
FCT_MSG_ERR_CREATION_CMDTT                  =	"Erreur création CmdTT"
FCT_MSG_ERR_DYNMEMINFO                      =	"DynamicMemoryInfo"
FCT_MSG_ERR_POSTE_SLOT                      =	"Poste: %s Slot: %d Erreur: %s"
FCT_MSG_ERR_MESSAGE                         =	"Message: %s\nSn Cie: %s\nCode produit Cie: %s\nIndice Cie: %s\n"
FCT_MSG_ERR_ENVOI_EMAIL                     =	"Envoie e-mail"
FCT_MSG_TT_CLIENT_NON_REMONTE               =	"La version du TT client n'est pas remontée"
FCT_MSG_ADR_BASE_TRACA_NON_REMONTE          =	"L'adresse de base de la traca n'est pas remontée"
FCT_MSG_HARDWARE_ID_NON_REMONTE             =	"La version du Hardware Id n'est pas remontée"
FCT_MSG_USAGE_ID_NON_REMONTE                =	"La version de l'Usage Id n'est pas remontée"
FCT_MSG_SFIN_SN_NON_REMONTE                 =	"Le SN du SFIN n'est pas remonté"
FCT_MSG_ERR_PROVIS_C_PLUS                   =	"La configuration du provisioning du produit C+ n'est pas conforme."
WRT_MSG_NAGRA_UNIQUE_ID_PB_LEN              =	"Pb len NAGRA_Unique_ID(hex)"
WRT_MSG_NAGRA_UNIQUE_ID_PB_FMT              =	"Pb format NAGRA_Unique_ID(hex)"
WRT_MSG_NAGRA_UNIQUE_ID_PB_SN               =	"Chipset Sn est différent du Nagra Unique Id"
WRT_MSG_NAGRA_STB_CA_SN_PB_FMT              =	"Pb format STB_CA_serial_number(hex)"
WRT_MSG_NAGRA_CRC_PB_FMT                    =	"Pb format NAGRA_CRC(hex)"
WRT_MSG_CHECK_NUMBER_PB_FMT                 =	"Pb format Check_Number(hex)"
WRT_MSG_CSCDATA_CHECK_NUMBER_PB_FMT         =	"Pb format CSCData_CheckNumber(hex)"
WRT_MSG_ERR_WRITENAGRALOG                   =	"Erreur WriteNagraLog : %s"
WRT_MSG_ERR_WTR_SN                          =	"Erreur WTR_SerialNumber : %s"
WRT_MSG_ECRITURE_SN_FIN                     =	"Fin Ecriture Numéro de série : OK"
WRT_MSG_ERR_DOCSIS                          =	"Erreur adresse MAC STB : lue = %s, attendue = %s"
WRT_MSG_DOCSIS                              =	"L'Adresse Mac Stb est égale à l'Adresse Mac mise dans le Docsis"
WRT_MSG_ECRITURE_DOCSIS_SETMAC_ERR          =	"Erreur écriture Mac Docsis"
WRT_MSG_ECRITURE_DOCSIS_SETMAC_FIN          =	"Fin Ecriture Adresse Mac Docsis: OK"
WRT_MSG_FLASH_VERIF_LOCK                    =	"Vérification lockage flash"
WRT_MSG_FLASH_PAS_LOCKEE                    =	"La flash n'est PAS lockée!!\n"
WRT_MSG_FLASH_BIEN_LOCKEE                   =	"La flash est bien lockée\n"
WRT_MSG_FLASH_LOCK_PWD_GENERIC              =	"Flash lockée avec un mot de passe générique\n"
WRT_MSG_FLASH_PASSER_PWD                    =	"Passer le password \n"
WRT_MSG_FLASH_DELOCK_OK_FIN                 =	"Fin Delockage Flash : OK"
WRT_MSG_FLASH_PASSAGE_PWD                   =	"Passage du password pour locker la flash"
WRT_MSG_FLASH_LOCKAGE_OK                    =	"Lockage Flash : OK"
WRT_MSG_FLASH_LOCKAGE                       =	"Lockage de la Flash"
WRT_MSG_FLASH_VERIF_AFTER_STD               =	"Verification si flash lockée"
WRT_MSG_ERREUR_CLE_STB                      =	"Ecriture de la clé stbpasswords en base"
WRT_MSG_CHIPSET_NON_SECURSIE                =	"LE CHIPSET N'EST PAS SECURISE"
WRT_MSG_CHIPSET_EST_SECURISE                =	"LE CHIPSET EST SECURISE"
WRT_MSG_CRYPTAGE_HDD                        =	"WTR_CryptageDisqueDur : %s"
WRT_MSG_ETH_FERMETURE_PORT                  =	"Fermeture port ethernet\n"
WRT_MSG_ETH_DESACTIVER                      =	"Desactiver Ethernet : %s"
WRT_MSG_ECRITURE_HW_ID                      =	"Ecriture Hardware_id : %s"
WRT_MSG_ECRITURE_MAN_ID                     =	"Ecriture Manufactured_ID : %s"
WRT_MSG_ECRITURE_HW_VERSION                 =	"Ecriture Version Hardware : %s"
WRT_MSG_ECRITURE_DWNLD_ID                   =	"Ecriture Download_id : %s"
WRT_MSG_ECRITURE_IP_SERVEUR_DL              =	"Ecriture IP serveur telechargement: %s "
WRT_MSG_ECRITURE_FICHIER_DL                 =	"Ecriture du fichier à télécharger ==> CHEMIN_TELECHARGEMENT"
WRT_MSG_CRYPTAGE_FLUX_DL                    =	"Cryptage du flux de telechargement"
WRT_MSG_ERREUR_TT_FINALISATION              =	"Erreur commande TT de finalisation decodeur"
WRT_MSG_ACTIVE_CUSTOM_PRERECETTE            =	"Activation du démarrage customisé en pre-recette"
WRT_MSG_ACTIVE_CUSTOM_UNDEF                 =	"La variable [etat_DEC_BPO_bFlagActiverPreReset] n est pas définie"
WRT_MSG_SWITCH_TT_PANA                      =	"Switch sur le TT Panasonic"
WRT_MSG_FORCAGE_TT_TO_APPLI                 =	"Forçage passage TT -> Appli"
WRT_MSG_FORCAGE_TELECHARGEMENT              =	"Forçage du téléchargement"
WRT_MSG_EFFACE_ZONE_TT                      =	"Effacement zone TT"
WRT_MSG_CHIPSET_PAIRING                     =	"Chipset pairing"
WRT_MSG_LOCKAGE_JTAG                        =	"Lockage du JTAG"
WRT_MSG_ACTIVE_CRYPTOCORE                   =	"Activation cryptocore"
WRT_MSG_FUSIBLE_DRM                         =	"Fusible DRM"
WRT_MSG_ERREUR_WRITETRACKING                =	"Erreur WriteTracking : %s"
WRT_MSG_ERREUR_SECURISATION                 =	"Erreur Sécurisation : %s"
WRT_MSG_ERREUR_WTR_SSLSN                    =	"Erreur WTR_SslCertificateSerialNumber : %s"
WRT_MSG_ECRITURE_SSLSN_FIN                  =	"Fin Ecriture du Serial number du certificat SSL : OK"
WRT_MSG_FUSES_ERREUR_VERIF                  =	"ERREUR FUSE : le champ recherché [%s] est à l'état %s au lieu de l'état %s"
WRT_MSG_FUSES_CONFIRM_VERIF                 =	"INFO FUSE : le champ recherché [%s] est bien à l'etat %s"
WRT_MSG_FUSES_ACTIV_OK                      =	"INFO FUSE : Vérification de la liste des fusibles activés OK"
WRT_MSG_FUSES_ACTIV_SKIPPE                  =	"INFO FUSE : Pas de liste de fusible activés à vérifier... vérification skippée"
WRT_MSG_FUSES_DESACTIV_OK                   =	"INFO FUSE : Vérification de la liste des fusibles désactivés OK"
WRT_MSG_FUSES_DESACTIV_SKIPPE               =	"INFO FUSE : Pas de liste de fusible désactivés à vérifier... vérification skippée"
WRT_MSG_STATUS_JTAG                         =	"Get Fuse Status JTAG: %s"
WRT_MSG_STATUS_DSC                          =	"Get Fuse Status DSC: %s"
WRT_MSG_STATUS_CW                           =	"Get Fuse Status CW Secure: %s"
WRT_MSG_FUSIBLE_MES                         =	"Activation du MES"
WRT_MSG_PWD_FLASH_KO                        =	"Protection par mot de passe KO"
WRT_MSG_PWD_FLASH_OK                        =	"Protection par mot de passe OK"
WRT_MSG_NOVERIF_PWD_FLASH                   =	"ATTENTION: Vérification du password de lockage flash désactivée"
WRT_MSG_SECTEUR_FLASH_LOCK_KO               =	"Zone n°%i Secteur n°%i NON Locké"
WRT_MSG_SECTEUR_FLASH_LOCK_OK               =	"Zone n°%i Secteur n°%i Locké"
WRT_MSG_PROP_SFIN                           =	"la propriété liée au SFIN [%s] n est pas configurée"
TNT_BBX_MSG_INIT                            =	"BBX_Initialize = %d\n"
TNT_BBX_MSG_WARNING                         =	"Warning (%d)\n"
TNT_BBX_MSG_ERREUR                          =	"Erreur (%d)\n"
TNT_BBX_MSG_TERMINATE                       =	"BBX_Terminate = %d\n"
TNT_BBX_MSG_NEW_STB                         =	"------- nouveau décodeur : NS=%s, Id=%s ------\n"
TNT_BBX_MSG_CONNECT_ID                      =	"BBX_Connect = %d (sessionId %d)\n"
TNT_BBX_MSG_DIAGNOSTIC                      =	"BBX_Diagnostic = %d\n"
TNT_BBX_MSG_NVM_PREPARE                     =	"BBX_PrepareNvm = %d\n"
TNT_BBX_MSG_NVM_GET                         =	"BBX_GetNvm = %d\n"
TNT_BBX_MSG_DISCONNECT                      =	"BBX_Disconnect\n"
TNT_BBX_MSG_TEMPS                           =	"temps = %fs\n"
TNT_BBX_MSG_NVM_LIT_CLE                     =	"TNTClesPerso_BBX_LitCleNVM"
TNT_BBX_MSG_DIAGNOSTIC_TITRE                =	"------- Diagnostique du serveur Black Box  ------\n"
TNT_BBX_MSG_DIAGNOSTIC_CMD                  =	"TNTClesPerso_BBX_Diagnostic"
TNT_BBX_MSG_NVM_ANNULE_TITRE                =	"------- Annulation d'une clé NVM : Id=%s------\n"
TNT_BBX_MSG_NVM_CANCEL                      =	"BBX_CancelNvm = %d\n"
TNT_BBX_MSG_STRING_TO_BCD                   =	"StringToBCD"
TNT_BBX_MSG_PREPARE_CHIPSET_ID              =	"PrepareChipSetId"
TNT_BBX_MSG_NO_ERR_MSG                      =	"Pas de Message_BBX correspondant au code d'erreur"
TNT_BBX_MSG_WARNING_NO_FCT_CALL             =	"Warning The \"BBX_Initialize\" function has already been called. This new call will have no effect"
TNT_BBX_MSG_WARNING_CHIPSET_UNKNOWN         =	"Warning The ChipsetId is unknown of the BlackBox. The computation isn't started, the connection is kept opened, and new computation requests can be done"
TNT_BBX_MSG_WARNING_NO_COMPUTATION          =	"Warning No computation has been requested for this ChipsetId. The function has no effect"
TNT_BBX_MSG_WARNING_PROJECTID_UNKNOWN       =	"Warning The ProjectId is unknown of the BlackBox. The computation isn't started, the connection is kept opened, and new computation requests can be done"
TNT_BBX_MSG_WARNING_COMPUTATION_DONE        =	"Warning A computation request has already been done for this ChipsetId, and the Serial Number was different. The computation isn't started, the connection is kept opened, and new computation requests can be done"
TNT_BBX_MSG_WARNING_WAIT_RESPONSE           =	"Warning The response has not been received by the client. The server has not finished the computation. So the user of the library will have to call the function again a little later"
TNT_BBX_MSG_WARNING_COMPUTATION_LOST        =	"Warning The response has not been received by the client, but the maximum waiting time has been reached. The server has not finished the computation, but we consider the computation lost, and the response will never be received"
TNT_BBX_MSG_WARNING_WRONG_NVM_SIZE          =	"Warning The real size of the NVM returned by the server is greater than the size of the buffer. The function can't return the NVM to its caller. The caller can call this function again, until the time-out of the computation."
TNT_BBX_MSG_ERROR_INIT_LIBRARY              =	"Error The library must first be initialized. The client can't do anything before initialization"
TNT_BBX_MSG_ERROR_CLIENT_CANT_LOAD          =	"Error Neither the parameters to the \"BBX_Initialize\" function, nor the BBX_HOME variable are defined. The client can't load its configuration and won't be able to open connections to the server"
TNT_BBX_MSG_ERROR_NO_CONFIG_FILE            =	"Error Configuration file not found. The client can't load its configuration and won't be able to open connections to the server"
TNT_BBX_MSG_ERROR_CANT_READ_CONFIG          =	"Error Configuration file can't be read or interpreted. The client can't load its configuration and won't be able to open connections to the server"
TNT_BBX_MSG_ERROR_CANT_CONNECT              =	"Error The client can't connect to the server"
TNT_BBX_MSG_ERROR_CONNECTION_LOST           =	"Error The connection has been lost"
TNT_BBX_MSG_ERROR_MAX_CONNECTIONS           =	"Error Maximum number of connections reached. The connection is closed by the server, next to the transmission of the response"
TNT_BBX_MSG_ERROR_BAD_PROTOCOL              =	"Error The server doesn't know the protocol version asked by the BlackBox. The connection is closed by the server, next to the transmission of the response"
TNT_BBX_MSG_ERROR_UNKNOWN_SESSION_ID        =	"Error The sessionID given in the header is unknown. The computation isn't started, and the connection is closed by the server, next to the transmission of the response"
TNT_BBX_MSG_ERROR_INTERNAL                  =	"Error Internal Error See server logs for more informations"
TNT_BBX_MSG_ERROR_CANT_TERMINATE            =	"Error Connections are still opened. The termination can't be done (<=> operation cancelled)"
TNT_BBX_MSG_ERROR_INVALID_PARAMETER         =	"Error One or more parameters are invalid (null pointers). The operation can't be done (<=> operation cancelled)"
TNT_BBX_MSG_ERROR_NO_ERROR                  =	"No error"
TNT_BBX_MSG_GETBBXERRORSTRING               =	"GetBBXErrorString"
TNT_BBX_MSG_DISK_STATUS_OK                  =	"Disk Status : Ok\n"
TNT_BBX_MSG_DISK_STATUS_LOW                 =	"Disk Status : the free space is lower than a threshold, configured on server side\n"
TNT_BBX_MSG_DISK_STATUS_FULL                =	"Disk Status : the disk is full\n"
TNT_BBX_MSG_DISK_STATUS_UNKNOWN             =	"Disk Status : valeur de parametre inconnue\n"
TNT_BBX_MSG_RAID_STATUS_OK                  =	"Raid Disk Status : Ok\n"
TNT_BBX_MSG_RAID_STATUS_NOREDUNDANT         =	"Raid Disk Status : the disks are no more redundant\n"
TNT_BBX_MSG_RAID_STATUS_UNKNOWN             =	"Raid Disk Status : valeur de parametre inconnue\n"
TNT_BBX_MSG_POWER_STATUS_OK                 =	"Power Status : Ok\n"
TNT_BBX_MSG_POWER_STATUS_NOREDUDANT         =	"Power Status : the power supplies are no more redundant\n"
TNT_BBX_MSG_POWER_STATUS_UNKNOWN            =	"Power Status : valeur de parametre inconnue\n"
TNT_BBX_MSG_FAIL_STATUS_OK                  =	"Fail Over Status : Ok\n"
TNT_BBX_MSG_FAIL_STATUS_DOWN                =	"Fail Over Status : one of the servers is down\n"
TNT_BBX_MSG_FAIL_STATUS_UNKNOWN             =	"Fail Over Status : valeur de parametre inconnue\n"
TNT_BBX_MSG_GETBBXDIAGSTRING                =	"GetBBXDiagString"
TNT_BBX_MSG_NVM_TRACE                       =	"trace"